Gg, Gg, Gg, Gg, Gg, Gg, Gg, Gg, Gg, Gg, Gg, Gg, Gg, Gg, Gg, Gg, Gg, Gg, Gg, Gg, Re^Eff, Re^Eff, Gll^Fdf, Re^Gvs, Re^Gvs, Re^Gvs, Re^Gvs, Re^Gvs, Re^Gvs, Re^Gvs, Re^Gvs, Re^Gvs, Re^Gvs, Re^Gvs, Re^Gvs, Rb, Rb, Rb, Gll^Fdf
Gg, Gg, Gg, Gg, Gll^Fdf, Gll, Gg, Gg, Gg, Gg, Gs^Vh, Gg, Rr, Gg, Rr, Rr, Rr, Rr, Rr, Rr, Rr, Re^Eff, Re^Eff, Re^Gvs, Re^Gvs, Re^Gvs, Re^Gvs, Re^Gvs, Re^Gvs, Re^Gvs, Re^Gvs, Re^Gvs, Re^Gvs, Re^Gvs, Rb, Rb, Re^Gvs, Rb, Rb
Rr, Rr, Rr, Rr, Rr, Rr, Rr, Rr, Rr, Rr, Rr, Rr, Gg, Rr, Gll, Gg, Gg, Gg, Gg, Gg, Gg, Rr, Rr, Re^Eff, Re^Eff, Re^Gvs, Re^Gvs, Re^Gvs, Re^Gvs, Re^Gvs, Re^Gvs, Re^Gvs, Rb, Rb, Re^Gvs, Re^Gvs, Re^Gvs, Re^Gvs, Re^Gvs
Gg, Gg, Ce, Ce, Ce, Gg, Gll, Gll^Fdf, Gll, Gll, Gg, Gg^Efm, Gll, Gg, Gll^Fdf, Gll, Gg, Gg, Ss, Gg, Gg, Gg, Gg, Rr, Rr, Re^Eff, Re^Eff, Re^Gvs, Re^Gvs, Re^Gvs, Rb, Rb, Re^Gvs, Re^Gvs, Re^Gvs, Re^Gvs, Re^Gvs, Re^Gvs, Re^Gvs
Gg, Gll^Fdf, Gll, Ke, Gll^Fdf, Gg, Gll^Fdf, Gll, Gg, Gg, Gg, Gg, Gll^Fdf, Gll, Gll, Gg, Ss, Ss, Ss^Vhs, Ss, Ss, Gg^Es, Gg, Gg, Gg^Efm, Rr, Rr, Re^Eff, Rb, Rb, Gs^Vh, Re^Gvs, Re^Gvs, Re^Gvs, Re^Gvs, Re^Gvs, Re^Gvs, Re^Gvs, Re^Gvs
Gg, Gg, Gll, Gll^Fdf, Hh, Gll^Fdf, Hh, Hh, Hh, Hh, Hh, Gll^Fdf, Hh, Gg, Gg, Gg, Ss, Ss, Ss, Ss, Ss, Gg, Gg, Gg, Gg, Gg, Rp, Rr, Rr, Re^Eff, Re^Eff, Re^Gvs, Re^Gvs, Re^Gvs, Re^Gvs, Re^Gvs, Re^Gvs, Re^Gvs, Re^Gvs
Gg, Gg, Gll, Gll^Fdf, Hh, Hh, Hh, Mm, Hh, Hh, Mm, Hh, Mm, Hh, Hh, Ss, Ss, Ss, Ss, Ss, Ss, Ss, Gg, Gg, Rp, Rp, Gg, Gg, Gg, Rr, Rr, Re^Eff, Re^Eff, Re^Gvs, Re^Gvs, Re^Gvs, Re^Gvs, Re^Gvs, Re^Gvs
Gg, Gll, Gg^Efm, Gll, Gll, Hh, Hh, Gll^Fdf, Hh, Hh, Hh, Hh, Hh, Hh, Gg, Ss, Ss, Ss, Chs, Chs, Ss, Ww, Ww^Bw/r, Rp, Gg, Gs^Vh, Gg^Efm, Gg, Gg, Gg, Gs^Vh, Rr, Rr, Re^Eff, Re^Eff, Re^Gvs, Gll^Fdf, Re^Gvs, Re^Eff
Gg, Gll^Fdf, Gll, Gg, Gll^Fdf, Gll, Rp, Gll, Gll^Fdf, Hh, Gs^Vl, Hh, Gll, Hh, Hh, Ss, Ss, Ss, Ww, Khs, Ww^Bw/r, Ww^Bw/r, Ww, Ww, Gg, Gg, Gll, Gll, Gll, Gg, Gg, Gg, Gg, Rr, Rr, Re^Eff, Re^Eff, Re^Eff, Ch
Rp, Rp, Rp, Rp, Rp, Rp, Gll^Fdf, Rp, Rp, Gll, Rp, Gg, Rp, Gll^Fdf, Gll^Fdf, Gll, Gg, Gg, Ww^Bw/r, Ww^Bw/r, Ww, Ww, Ww, Ww, Gg, Gg, Gll, Gll^Fdf, Gll^Fdf, Gll, Gll, Gg, Gg, Gg, Gg, Rr, Rr, Gll, Ch
Gg, Gll, Gll^Fdf, Gg, Hh, Gg, Hh, Gll, Hh, Rp, Gll^Fdf, Rp, Gll^Fdf, Rp, Rp, Rp, Rp, Rp, Chw, Khw, Ww, Ww, Ww, Ww, Gg^Es, Gg, Gll, Gll^Fdf, Gll^Fdf, Gll^Fdf, Gll^Fdf, Gll, Gg^Efm, Gg, Gg, Gg, Gg, Rr, Rr
Gg, Gll, Gll, Gg, Hh, Hh, Hh, Hh, Hh, Hh, Hh, Hh, Hh, Hh, Hh, Gg, Gll, Ww, Ww, Chw, Ww, Ww, Ww, Ww, Gg, Gg, Gll, Gll^Fdf, Gll^Fdf, Gll^Fdf, Gll^Fdf, Gll^Fdf, Gll, Gg^Es, Gg, Gg, Gg, Gg, Ch
Gg, Gll, Gll, Gg, Hh, Hh, Hh, Mm, Hh, Hh, Hh, Mm, Hh, Hh, Hh, Gll, Gll^Fdf, Gg, Ww, Ww, Ww, Ww, Gg, Gg, Gg, Gg^Efm, Gll, Gll^Fdf, Gll^Fdf, Gll^Fdf, Gll^Fdf, Gll, Gg, Gg, Gg, Gg^Efm, Gg, Gg, Ch
Gg, Gll^Fdf, Gll, Gll, Gg, Hh, Gg^Efm, Hh, Gg, Hh, Gg, Hh, Hh, Mm, Hh, Hh, Gg, Gg^Efm, Gg, Ww, Gg, Gg, Gg, Gg^Es, Gg, Gg, Gg, Gll, Gll^Fdf, Gll^Fdf, Gll, Gll, Gg, Gg, Gg, Gg, Gg, Gg, Ch
Gg, Gg, Gg, Gll^Fdf, Gg, Gg^Efm, Gg, Gg, Gg, Gg, Gg, Gg, Gg, Hh, Gg, Hh, Hh, Gg, Gg, Gg, Gg, Gg, Gg, Gg, Gg, Gg, Gg, Gg, Gg, Gg, Gg, Gg, Gg, Gg, Gg, Gg, Gg, Gg, Ch
