Gll^Fdf, Gs, Gll^Fdf, Gll^Fdf, Gll, Gs, Gll, Gll^Fdf, Gll^Fdf, Gll^Fdf, Gll^Fdf, Gll, Gll, Gs, Gs, Gs, Gs, Gs, Gll, Gs, Gll, Gs, Re^Eff, Re^Gvs, Re^Gvs, Re^Gvs, Re^Gvs, Re^Gvs, Re^Gvs, Re^Gvs, Re^Gvs, Re^Gvs, Rb
Gll, Gll^Fdf, Gll^Fdf, Gll^Fdf, Gll, Gs, Gll, Gll^Fdf, Gll^Fdf, Gll^Fdf, Gll, Gll, Gs, Gs, Gs, Gs, Gs, Gll, Gll^Fdf, Gll^Fdf, Gll^Fdf, Gll^Fdf, Gll, Re^Eff, Re^Eff, Re^Gvs, Re^Gvs, Re^Gvs, Re^Gvs, Re^Gvs, Rb, Rb, Re^Gvs
Rr, Gll, Gll, Gll, Rr, Gs, Ch, Gll, Gs, Gs, Gs, Gs, Gs, Gs, Gs, Gs, Gll^Fdf, Gll, Gs, Gll, Gll, Gll^Fdf, Gll, Gs, Gs, Gll^Fdf, Gs^Vh, Re^Gvs, Rb, Rb, Re^Gvs, Re^Gvs, Re^Gvs
Gll, Rr, Rr, Rr, Gs, Rr, Rr, Gs, Rr, Rr, Rr, Rr, Rr, Gll, Gll^Fdf, Mm, Gll^Fdf, Gll, Gs, Gs, Rr, Gs, Rr, Gs, Rr, Rr, Rr, Rb, Re^Wm, Re^Gvs, Re^Gvs, Re^Gvs, Re^Gvs
Gll^Fdf, Gll, Gll, Gs, Gll, Ch, Gs, Rr, Gll, Gll^Fdf, Gll, Gll^Fdf, Gll, Rr, Rr, Rr, Rr, Rr, Rr, Rr, Gs, Rr, Gs, Rr, Gll, Gll^Fdf, Gll^Fdf, Rr, Rr, Re^Eff, Re^Eff, Re^Gvs, Re^Gvs
Gll^Fdf, Gll^Fdf, Gll, Gll, Gll^Fdf, Gll, Gll, Gll, Gll, Gll, Gll, Gll, Gll^Fdf, Gll^Fdf, Gll, Gll, Gll, Gs, Gll, Gll, Gll, Gs, Gll, Gs, Gll, Gll, Ss, Gll^Fdf, Gll^Fdf, Rr, Rr, Re^Eff, Re^Eff
Gll, Gll, Gll, Gll, Gll^Fdf, Gll, Gll^Fdf, Gll^Fdf, Gll^Fdf, Gll^Fdf, Hh, Gll, Hh, Gll, Gll^Fdf, Gll^Fdf, Gll, Gll, Gll, Gll^Fdf, Gll^Fdf, Gll, Gll^Fdf, Gll, Ss, Ss, Ss^Vhs, Ss, Ss, Gll^Fdf, Rp, Rr, Rr
Gll^Fdf, Gll^Fdf, Gll, Gll^Fdf, Gll^Fdf, Gll, Gll^Fdf, Hh, Hh, Hh, Mm, Hh, Hh, Hh, Hh, Hh, Hh, Gll^Fdf, Gll^Fdf, Gll, Gll, Gll^Fdf, Gll, Ss, Ss, Ss, Ss, Ss, Ss, Gll^Fdf, Rp, Rr^Vhc, Gll
Gll, Gll^Fdf, Gs, Gll^Fdf, Gll, Gll, Gll, Hh, Hh, Hh, Gll^Fdf, Hh, Hh, Mm, Hh, Mm, Hh, Hh, Gll^Fdf, Gll^Fdf, Gll, Gll, Ss, Ss, Ss, Ss, Ss, Ss, Ss, Ss, Rp, Gll^Fdf, Gll^Fdf
Gll, Gll, Gll, Gs, Gll, Gll^Fdf, Gll^Fdf, Gll, Gll, Hh, Gll^Fdf, Hh, Hh, Hh^Ecf, Ker, Hh, Hh, Gll^Fdf, Gll, Gll, Gll^Fdf, Gll, Ss, Ss, Ss, Ss, Chs, Chs, Ss, Gll^Fdf, Rp, Gll^Fdf, Gll
Gll, Gll, Gll^Fdf, Gs, Rp, Gll^Fdf, Rp, Gll^Fdf, Rp, Rp, Rp, Gll^Fdf, Gll, Cer, Cer, Cer, Gll^Fdf, Hh, Gll, Gll^Fdf, Gll^Fdf, Gll, Ss, Ss, Gll, Ss, Ww, Khs, Ww^Bw/r, Ww^Bw/r, Ww, Ww, Ww
Rp, Gll^Fdf, Rp, Rp, Gs, Rp, Gll^Fdf, Rp, Gll, Gll^Fdf, Gll, Rp, Rp, Rp, Rp, Rp, Rp, Gll^Fdf, Rp, Gll^Fdf, Rp, Rp, Rp, Gll^Fdf, Gll, Ss, Ww^Bw/r, Ww^Bw/r, Ww, Ww, Ww, Ww, Ww
Gll^Fdf, Rp, Gs, Gs, Gll, Gll, Gll, Hh, Hh, Hh, Hh, Hh, Hh, Gll^Fdf, Hh, Gll^Fdf, Hh, Rp, Gll, Rp, Gll^Fdf, Gll, Gll^Fdf, Rp, Rp, Rp, Chw, Khw, Ww, Ww, Ww, Ww, Ww
Gll^Fdf, Gll, Gs, Gll, Gll^Fdf, Gll^Fdf, Gll, Hh, Hh, Hh, Mm, Hh, Hh, Hh, Mm, Hh, Hh, Hh, Gll, Gll^Fdf, Gll^Fdf, Gll, Gll^Fdf, Ww, Ww, Ww, Ww, Chw, Ww, Ww, Ww, Ww, Ww
Gs, Gll, Gs, Gll, Gll, Gll^Fdf, Gs, Hh, Hh, Hh, Hh, Hh, Hh, Hh, Hh, Hh, Mm, Hh, Hh, Gll^Fdf, Gll, Gll, Gs, Ww, Ww, Ww, Ww, Ww, Ww, Ww, Ww, Ww, Ww
