Rrc, Gg, Gs^Fms, Gg, Gg, Gg, Gg, Gg, Gg, Rrc, Gg, Gg, Gg, Gg, Gg, Gs^Fds, Gs^Fds, Gg, Gs^Fds, Gg, Gg, Gg, Gs^Fds, Gs^Fds, Gs^Fds, Gs^Fds, Gs^Fds, Gg, Gs^Fds, Gg, Gs^Fds, Gs^Fds, Gg, Gg, Gs^Fds, Ce, Ce, Ce, Rrc, Rrc, Ds, Ds, Ww, Ww, Wo, Wo, Wo
Gs^Fms, Rrc, Rrc, Gg, Gs^Fms, Gs^Fms, Gg, Gs^Fms, Gg, Gg, Gs^Fms, Gg, Gs^Fms, Gg, Gs^Fds, Gg, Gs^Fds, Gs^Fds, Gg, Gg, Gs^Fds, Gg, Gs^Fds, Gg, Gg, Gg, Gs^Fms, Gg, Gg, Gs^Fds, Gs^Fms, Gs^Fds, Gs^Fds, Gg, Gs^Fds, Ce, Ce, Ce, Rrc, Ds, Ds, Ds, Ww, Ww, Wo, Wo, Wo
Gg, Gg, Ce, Rrc, Rrc, Gg, Gg, Gs^Fds, Gs^Fms, Gg, Gg, Gg, Gg, Gg, Gs^Fds, Gg, Gg, Gg, Gs^Fds, Gs^Fds, Gg, Gg, Gg, Gs^Fds, Gg, Gs^Fds, Gg, Gs^Fms, Gs^Fds, Gg, Gs^Fds, Gg, Gg, Gg, Re^Vct, Ce, Gs^Fds, Ce, Rrc, Ds, Ds, Ds, Ww, Ww, Wo, Wo, Wo
Ce, Ke, Ce, Ce, Ce, Rrc, Rrc, Gg, Gg, Gs^Fds, Gg, Gs^Fms, Gg, Gg, Gg, Gs^Fds, Gs^Fms, Gg, Gg, Gs^Fds, Gg, Gg, Gg, Gs^Fds, Gg, Gg, Gg, Gs^Fds, Gs^Fds, Gg, Gg, Gg, Gs^Fds, Gs^Fms, Gg^Ecf, Gs^Fds, Gs^Fds, Ke, Rrc, Ds, Ds, Ds, Ww, Ww, Wo, Wo, Wo
Gg, Gg, Ce, Re^Vct, Gg, Gs^Fds, Gg, Rrc, Rrc, Gs^Fds, Gg, Gg, Gs^Fds, Gg, Gs^Fms, Gg, Gs^Fds, Gg, Gs^Fds, Gs^Fds, Gs^Fms, Gs^Fds, Gg, Gg, Gg, Gs^Fds, Gs^Fds, Gs^Fms, Gg, Gg, Gg, Gg, Gs^Fds, Gg, Gs^Fds, Re^Vct, Gs^Fds, Re^Vct, Rrc, Ds, Ds, Ww, Ww, Ww, Wo, Wo, Wo
Gg, Re^Vct, Gg, Gg^Ecf, Re^Vct, Gg, Gg, Gg, Gg, Rrc, Rrc, Gg, Gg, Gg, Gg, Gg, Gg, Gs^Fds, Gs^Fms, Gg, Gg, Gs^Fds, Gs^Fds, Gg, Gs^Fds, Gg, Gs^Fds, Gs^Fds, Gg, Gg, Gs^Fms, Gs^Fds, Gs^Fds, Gs^Fds, Gg, Gs^Fds, Gg, Gg, Rrc, Ds, Ds, Ww, Ww, Ww, Wo, Wo, Wo
Gg, Gg, Gs^Fds, Gg, Gs^Fds, Gg, Gg, Gs^Fms, Gg, Gs^Fms, Gg, Rrc, Rrc, Gs^Fms, Gg, Gg, Gs^Fms, Gg, Gg, Gg, Gg, Gg, Gg, Gs^Fds, Gg, Gg, Gg, Gg, Gs^Fms, Gs^Fds, Gs^Fds, Gs^Fds, Gg, Gs^Fms, Gg, Gg, Gg, Gg, Rrc, Ds, Ds, Ww, Ww, Wo, Wo, Wo, Wo
Gg, Gs^Fds, Gg, Gs^Fms, Gg, Gs^Fds, Gs^Fms, Gg, Gg, Gg, Gs^Fms, Gg, Gg, Rrc, Rrc, Gg, Gg, Gg, Gg, Gg, Gg, Gs^Fms, Gg, Gs^Fds, Gg, Gg, Gg, Gg, Gg, Gg, Gg, Gg, Re^Eff, Gs^Vh, Re^Eff, Gg, Gg, Rrc, Ds, Ds, Ds, Ww, Ww, Wo, Wo, Wo, Wo
Gg, Gs^Fms, Gs^Fds, Gg, Gs^Fds, Gg, Gg, Gg, Gg, Gg, Gg, Gg, Gg, Gg, Gg, Rrc, Rrc, Gg, Gg, Gg, Gs^Fms, Gg, Gg, Gg, Gs^Fms, Gs^Fds, Gg, Gg, Gg, Gg, Re^Eff, Re^Eff, Re^Gvs, Re^Gvs, Re^Gvs, Re^Eff, Re, Rrc, Ds, Ds, Ww, Ww, Ww, Wo, Wo, Wo, Wo
Gg, Gs^Fds, Gg, Gg, Gs^Fms, Gg, Gg, Gg, Gs^Fms, Gg, Gs^Fms, Gg, Gg, Gg, Gg, Gs^Vh, Re^Gvs, Rrc, Rrc, Gg, Gg, Gg, Gg, Gg, Gg, Gs^Fds, Gs^Fds, Gs^Fds, Gg, Re^Wm, Re^Eff, Re^Gvs, Re^Gvs, Re^Gvs, Re^Gvs, Re^Gvs, Gs^Vh, Rrc, Ds, Ds, Ww, Ww, Ww, Wo, Wo, Wo, Wo
Gg, Gg, Gg, Gs^Fds, Gs^Fms, Gg, Gg, Gs^Fms, Gg, Gg, Gg, Gg, Gg, Gg, Re^Gvs, Re^Gvs, Re^Wm, Re^Gvs, Re^Gvs, Rrc, Rrc, Gg, Gg, Gg, Gg, Gg, Gg, Gg, Gg, Gg, Gg, Re^Eff, Re^Eff, Re^Gvs, Re^Eff, Re^Eff, Gg, Rrc, Ds, Ds, Ww, Ww, Wo, Wo, Wo, Wo, Wo
Gg, Gg, Gs^Fms, Gg, Gg, Gg, Gg, Gg, Gs^Fms, Gg, Gg, Gg, Re^Gvs, Re^Gvs, Re^Gvs, Re^Gvs, Re^Gvs, Re^Gvs, Re^Gvs, Re^Gvs, Re^Gvs, Rrc, Rrc, Gg, Gg, Gg, Gg, Gg, Gg, Gg, Gg, Gg, Gg, Re^Eff, Gg, Gg, Gg, Rrc, Ds, Ds, Ww, Ww, Wo, Wo, Wo, Wo, Wo
Gg, Gg, Gs^Fms, Gg, Gg, Gg, Gg, Gg, Gg, Gg, Re^Gvs, Re^Gvs, Re^Gvs, Re^Gvs, Re^Gvs, Re^Gvs, Re^Gvs, Re^Gvs, Re^Gvs, Re^Gvs, Re^Gvs, Re^Gvs, Re^Gvs, Rrc, Rrc, Gg, Gg, Gg, Gg, Gg, Ch, Ch, Ch, Gg, Gg, Gg, Gg, Rrc, Ds, Ds, Ww, Ww, Wo, Wo, Wo, Wo, Wo
Gg, Gg, Gg, Gg, Gs^Fms, Gg, Gg, Gs^Vh, Re^Gvs, Re^Gvs, Re^Gvs, Re^Gvs, Re^Gvs, Re^Gvs, Re^Gvs, Re^Gvs, Re^Gvs, Re^Gvs, Re^Gvs, Re^Gvs, Re^Gvs, Re^Gvs, Re^Gvs, Re^Gvs, Re^Gvs, Rrc, Rrc, Gg, Ch, Ch, Gg, Gg, Gg, Ch, Ch, Gg, Rrc, Rrc, Ds, Ds, Ww, Ww, Wo, Wo, Wo, Wo, Wo
Gg, Gg, Gg, Gg, Gg, Gg, Gg, Gg, Gg, Re^Gvs, Re^Gvs, Re^Gvs, Re^Gvs, Re^Gvs, Re^Wm, Re^Gvs, Re^Gvs, Re^Gvs, Re^Gvs, Re^Wm, Re^Gvs, Re^Gvs, Re^Gvs, Re^Gvs, Gg, Gg, Ch, Rrc, Rrc, Gg, Gs^Fds, Gs^Fds, Gg, Re, Rr^Vhc, Ch, Rrc, Ds, Ds, Ds, Ww, Ww, Wo, Wo, Wo, Wo, Wo
Gg, Gs^Fms, Gg, Gg, Gs^Fms, Gg, Gg, Gg, Gg, Gg, Gg, Re^Gvs, Re^Gvs, Re^Gvs, Re^Gvs, Re^Gvs, Re^Gvs, Re^Gvs, Re^Gvs, Re^Gvs, Re^Gvs, Re^Gvs, Gg, Gg, Ch, Ch, Gg, Rr^Vhc, Rrc, Rrc, Rrc, Gg^Efm, Rr^Vhc, Gs^Fds, Rrc, Rrc, Ch, Ds, Ds, Ds, Ww, Ww, Wo, Wo, Wo, Wo, Wo
Gg, Gg, Gg, Gg, Gg, Gg, Gg, Gg, Gs^Fms, Gg, Gg, Gs^Vh, Rrc, Re^Gvs, Re^Gvs, Re^Gvs, Re^Gvs, Re^Gvs, Re^Gvs, Re^Gvs, Gg, Gg, Gg, Ch, Gg^Efm, Gg, Gs^Fds, Rrc, Ch, Ch, Ch, Rrc, Rrc, Rrc, Gs^Fds, Rr^Vhc, Ch, Ds, Ds, Ww, Ww, Ww, Wo, Wo, Wo, Wo, Wo
Gg, Gg, Re^Vct, Gg, Gg, Gg, Gg, Gg, Gg, Gg, Rrc, Rrc, Gg, Rrc, Rrc, Re^Gvs, Re^Gvs, Re^Gvs, Rrc, Gg, Rrc, Rrc, Rrc, Rrc, Rrc, Gg, Rr^Vhc, Rrc, Ch, Kh, Ch, Rrc, Rr^Vhc, Re^Efm, Gg, Gg, Ch, Ds, Ds, Ww, Ww, Ww, Wo, Wo, Wo, Wo, Wo
Rrc, Rrc, Rrc, Rrc, Rrc, Rrc, Rrc, Gg, Rrc, Rrc, Gg, Gg, Gg, Gg, Gg, Rrc, Rrc, Rrc, Gg, Rrc, Gg, Gg, Gg, Ch, Rr^Vhc, Rrc, Rrc, Rrc, Rrc, Rrc, Rrc, Rrc, Rrc, Gs^Fds, Re, Gs^Fds, Ch, Ds, Ww, Ww, Ww, Wo, Wo, Wo, Wo, Wo, Wo
Gg, Gg, Ce, Ce, Ke, Re^Vct, Gg, Rrc, Gg, Gg, Gg, Gg, Gg, Gg, Gg, Gg, Gg, Gg, Gg, Gg, Gg, Gg, Gg, Ch, Gg, Gg^Efm, Rrc, Ch, Ch, Kh, Ch, Ch, Rrc, Rr^Vhc, Ww, Re, Ch, Ds, Ww, Ww, Wo, Wo, Wo, Wo, Wo, Wo, Wo
Gg, Ce, Ds, Ce, Re^Vct, Gg^Ecf, Gg, Gg, Gg, Gg, Gg, Gg, Gg, Gg, Gg, Gg, Gg, Gg, Gg, Gg, Gg, Gg, Gg, Ch, Gg, Gg, Rr^Vhc, Rrc, Rrc, Ch, Rrc, Rrc, Wo, Wo^Bw\, Wo^Bw\, Ww, Ww, Ww, Ww, Ww, Wo, Wo, Wo, Wo, Wo, Wo, Wo
Ds, Ds, Ds, Ce, Ds, Gg, Ds, Gg, Ds, Gg, Ds, Gg, Ds, Gg, Ds, Gg, Ds, Gg, Ds, Gg, Ds, Gg, Ds, Ch, Ds, Ds, Ds, Rrc, Rrc, Rrc, Wo, Wo^Bw\, Wo^Bw\, Wo, Wo, Wo^Bw\, Wo^Bw\, Ww, Wo, Wo, Wo, Wo, Wo, Wo, Wo, Wo, Wo
Ds, Ds, Ds, Ds, Ds, Ds, Ds, Ds, Ds, Ds, Ds, Ds, Ds, Ds, Ds, Ds, Ds, Ds, Ds, Ds, Ds, Ds, Ds, Ch, Ds, Ds, Ds, Ds, Wo, Wo^Bw\, Wo^Bw\, Wo, Wo, Wo^Bw\, Wo^Bw\, Wo, Wo, Wo, Wo, Wo, Wo, Wo, Wo, Wo, Wo, Wo, Wo
Ww, Ds, Ww, Ds, Ww, Ds, Ww, Ds, Ww, Ds, Ww, Ds, Ww, Ds, Ww, Ds, Ww, Ds, Ww, Ds, Ww, Ds, Ww, Ww, Ww, Ww, Ww, Ww, Wo, Wo, Wo, Wo^Bw\, Wo^Bw\, Wo, Wo, Wo, Wo, Wo, Wo, Wo, Wo, Wo, Wo, Wo, Wo, Wo, Wo
Ww, Ww, Ww, Ww, Ww, Ww, Ww, Ww, Ww, Ww, Ww, Ww, Ww, Ww, Ww, Ww, Ww, Ww, Ww, Ww, Ww, Ww, Ww, Ww, Ww, Ww, Ww, Ww, Wo, Wo, Wo, Wo, Wo, Wo, Wo, Wo, Wo, Wo, Wo, Wo, Wo, Wo, Wo, Wo, Wo, Wo, Wo
Ww, Ww, Ww, Ww, Ww, Ww, Ww, Ww, Ww, Ww, Ww, Ww, Ww, Ww, Ww, Ww, Ww, Ww, Ww, Ww, Ww, Ww, Wo, Ww, Wo, Ww, Wo, Wo, Wo, Wo, Wo, Wo, Wo, Wo, Wo, Wo, Wo, Wo, Wo, Wo, Wo, Wo, Wo, Wo, Wo, Wo, Wo
Wo, Wo, Wo, Wo, Wo, Wo, Wo, Wo, Wo, Wo, Wo, Wo, Wo, Wo, Wo, Wo, Wo, Wo, Wo, Wo, Wo, Wo, Wo, Wo, Wo, Wo, Wo, Wo, Wo, Wo, Wo, Wo, Wo, Wo, Wo, Wo, Wo, Wo, Wo, Wo, Wo, Wo, Wo, Wo, Wo, Wo, Wo
Wo, Wo, Wo, Wo, Wo, Wo, Wo, Wo, Wo, Wo, Wo, Wo, Wo, Wo, Wo, Wo, Wo, Wo, Wo, Wo, Wo, Wo, Wo, Wo, Wo, Wo, Wo, Wo, Wo, Wo, Wo, Wo, Wo, Wo, Wo, Wo, Wo, Wo, Wo, Wo, Wo, Wo, Wo, Wo, Wo, Wo, Wo
Wo, Wo, Wo, Wo, Wo, Wo, Wo, Wo, Wo, Wo, Wo, Wo, Wo, Wo, Wo, Wo, Wo, Wo, Wo, Wo, Wo, Wo, Wo, Wo, Wo, Wo, Wo, Wo, Wo, Wo, Wo, Wo, Wo, Wo, Wo, Wo, Wo, Wo, Wo, Wo, Wo, Wo, Wo, Wo, Wo, Wo, Wo
Wo, Wo, Wo, Wo, Wo, Wo, Wo, Wo, Wo, Wo, Wo, Wo, Wo, Wo, Wo, Wo, Wo, Wo, Wo, Wo, Wo, Wo, Wo, Wo, Wo, Wo, Wo, Wo, Wo, Wo, Wo, Wo, Wo, Wo, Wo, Wo, Wo, Wo, Wo, Wo, Wo, Wo, Wo, Wo, Wo, Wo, Wo
