Xoc, Xoc, Xoc, Xoc, Xoc, Xoc, Xoc, Xoc, Xoc, Xoc, Xoc, Xoc, Gd^Edb, Gd, Gd, Gd, Gd^Edb, Gd, Xoc, Xoc, Xoc, Xoc, Xoc, Xoc, Xoc, Xoc, Xoc, Xoc, Xoc
Xoc, Xoc, Xoc, Xoc, Xoc, Xoc, Xoc, Xoc, Xoc, Xoc, Re^Vct, Gd^Edb, Gd, Gd, Cvr, Gd, Gd, Gd, Re^Vct, Xoc, Xoc, Xoc, Xoc, Xoc, Xoc, Xoc, Xoc, Xoc, Xoc
Xoc, Xoc, Xoc, Xoc, Xoc, Xoc, Xoc, Xoc, Xoc, Xoc, Re^Vct, Gd^Edb, Gd, Cvr, Kvr, Cvr, Gd, Gd^Edb, Re^Vct, Xoc, Xoc, Xoc, Xoc, Xoc, Xoc, Xoc, Xoc, Xoc, Xoc
Xoc, Xoc, Xoc, Xoc, Xoc, Xoc, Xoc, Xoc, Xoc, Xoc, Re^Vct, Gd, Cvr, Cvr, Cvr, Cvr, Cvr, Gd, Re^Vct, Xoc, Xoc, Xoc, Xoc, Xoc, Xoc, Xoc, Xoc, Xoc, Xoc
Xoc, Xoc, Xoc, Xoc, Xoc, Xoc, Xoc, Xoc, Xoc, Xoc, Xoc, Gd, Gd, Cvr, Gd, Cvr, Gd, Gd, Xoc, Xoc, Xoc, Xoc, Xoc, Xoc, Xoc, Xoc, Xoc, Xoc, Xoc
Xoc, Xoc, Xoc, Xoc, Xoc, Xoc, Xoc, Xoc, Gg, Xoc, Xoc, Xoc, Gg, Gd, Gg, Gd, Gg, Xoc, Xoc, Xoc, Gg, Xoc, Xoc, Xoc, Xoc, Xoc, Xoc, Xoc, Xoc
Xoc, Xoc, Xoc, Xoc, Xoc, Xoc, Gg, Gg, Gll^Fp, Gg, Gg, Gg, Gg^Ve, Gg, Gg, Gg, Gll^Fp, Gg, Gg, Gg, Gll^Fp, Gg, Gg, Xoc, Xoc, Xoc, Xoc, Xoc, Xoc
Xoc, Xoc, Xoc, Xoc, Gll^Fp, Gll^Fp, Gg, Gg, Gg, Gg, Gg, Gg, Gg, Gg, Gll^Fp, Gg^Efm, Gg^Efm, Gg^Edb, Gg^Ve, Gg, Gll^Fp, Gg, Gg, Gll^Fp, Gll^Fp, Xoc, Xoc, Xoc, Xoc
Xoc, Xoc, Gll^Fp, Gll^Fp, Gg, Gg, Gg, Gg, Gll^Fp, Gll^Fp, Gg, Gg, Gll^Fp, Gll^Fp, Gg, Gg, Gg^Efm, Gg, Gg, Gg, Gg, Gll^Fp, Gg, Gll^Fp, Gll^Fp, Gll^Fp, Gg, Xoc, Xoc
Gll^Fp, Gg, Gg^Edb, Gll^Fp, Gg, Gg^Ve, Gg, Gll^Fp, Gll^Fp, Gll^Fp, Gll^Fp, Gg, Gg, Gg, Wo, Gg, Gg, Gg, Gll^Fp, Gll^Fp, Gg, Gg, Gg, Gg, Gg, Gg, Gg, Gg, Gg
Gll^Fp, Gg, Gg, Gg, Gg, Gg, Gg, Gg, Gg, Gll^Fp, Gg, Gg, Wo, Wo, Gg^Efm, Wo, Wo, Gg, Gg, Gll^Fp, Gg, Gg, Gll^Fp, Gg^Ve, Gg, Gg, Gll^Fp, Gll^Fp, Gll^Fp
Gll^Fp, Gg, Gg, Gll^Fp, Gg, Gll^Fp, Gg^Efm, Gg^Efm, Gg, Gg, Gg, Gg, Wo, Gg^Efm, Gg^Fet, Gg^Efm, Wo, Gg, Gll^Fp, Gg, Gll^Fp, Gg, Gg^Efm, Gg, Gll^Fp, Gg, Gll^Fp, Gll^Fp, Gg
Gg, Gg, Gg, Gg, Gll^Fp, Gg, Gg^Efm, Gg, Gll^Fp, Gll^Fp, Gll^Fp, Gg, Wo, Gg^Efm, Gg^Efm, Gg^Ve, Wo, Gg, Gg, Gll^Fp, Gll^Fp, Gg, Gg, Gg^Efm, Gg^Efm, Gg, Gg, Gll^Fp, Gg
Gg^Ve, Gll^Fp, Gg, Gg, Gg, Gg^Efm, Gg, Gll^Fp, Gg, Gll^Fp, Gll^Fp, Gg, Gg, Wo, Wo^Bsb|, Wo, Gg, Gg, Gll^Fp, Gg, Gg, Gll^Fp, Gg, Gll^Fp, Gg^Efm, Gg^Efm, Gg, Gg, Gll^Fp
Gll^Fp, Gll^Fp, Gg, Gg, Gll^Fp, Gg, Gg, Gg, Gg, Gg, Gg, Gll^Fp, Gg, Wo, Wo^Bsb|, Wo, Gg, Gg, Gg, Gll^Fp, Gg, Gg, Gg^Ve, Gll^Fp, Gg^Efm, Gg, Gg, Gll^Fp, Gll^Fp
Gg, Gll^Fp, Gg, Gg, Gll^Fp, Gg, Gg, Gll^Fp, Gg, Gg, Gll^Fp, Gg, Gg^Ve, Gg, Gg, Gg, Gll^Fp, Gg, Gg, Gll^Fp, Gll^Fp, Gg, Gg, Gg, Gg^Efm, Gll^Fp, Gg, Gg, Gll^Fp
Gg, Gll^Fp, Gll^Fp, Gg, Gg, Gg, Gll^Fp, Gg, Gg, Gll^Fp, Gg, Gg, Gg, Gg, Gg^Efm, Gg, Gg, Gll^Fp, Gg, Gg, Gg, Gll^Fp, Gg, Gg, Gg^Efm, Gg, Gg, Gg, Gg
Gg, Gg, Gg, Gg, Gll^Fp, Gg, Gg, Gg, Gll^Fp, Gll^Fp, Gg, Gll^Fp, Gg, Gg, Gg^Efm, Gg, Gg, Gll^Fp, Gg, Gg, Gg, Gg, Gll^Fp, Gll^Fp, Gg, Gg^Ve, Gg, Gll^Fp, Gg
Gg, Gll^Fp, Gll^Fp, Gll^Fp, Gg, Gg, Gg, Gg, Gll^Fp, Gg, Gll^Fp, Gg, Gg, Gg, Gg, Gg^Efm, Gg, Gg, Gg^Edb, Gll^Fp, Gg, Gg, Gll^Fp, Gg, Gg, Gll^Fp, Gg, Gg, Gg
Gll^Fp, Gll^Fp, Gg, Gg, Gg^Edb, Gg, Gll^Fp, Gll^Fp, Gg, Gll^Fp, Gll^Fp, Gg, Gg, Gll^Fp, Gg, Gg^Efm, Gg^Efm, Gg, Gll^Fp, Gg, Gg, Gll^Fp, Gll^Fp, Gg, Gg, Gg^Edb, Gll^Fp, Gll^Fp, Gg
Gg, Gll^Fp, Gg, Gg, Gll^Fp, Gg, Gll^Fp, Gg^Ve, Gg, Gg, Gll^Fp, Gg, Gg, Gg, Gg, Gg^Efm, Gg^Efm, Gg, Gg, Gg^Ve, Gg, Gll^Fp, Gll^Fp, Gg, Gll^Fp, Gg, Gll^Fp, Gll^Fp, Gg
Gg^Ve, Gll^Fp, Gg, Gg, Gll^Fp, Gll^Fp, Gg, Gll^Fp, Gg, Gg, Xoc, Xoc, Gg, Gg^Efm, Gg, Gg^Efm, Gg, Xoc, Xoc, Gg, Gg, Gll^Fp, Gg, Gll^Fp, Gg, Gg, Gg, Gg, Gg
Gg, Gg, Gg, Gll^Fp, Gll^Fp, Gll^Fp, Gg, Gll^Fp, Xoc, Xoc, Xoc, Gll^Fp, Gll^Fp, Gg, Gg, Gg^Efm, Gg, Gg^Dr, Xoc, Xoc, Xoc, Gg, Gg, Gg, Gll^Fp, Gll^Fp, Gg, Gg^Ve, Gg
Gg, Gll^Fp, Gll^Fp, Gll^Fp, Gg, Gg, Xoc, Xoc, Xoc, Xoc, Xoc, Gg^Dr, Gg, Gg, Gg, Gg^Efm, Gg, Gll^Fp, Xoc, Xoc, Xoc, Xoc, Xoc, Gg, Gg, Gg, Gll^Fp, Gll^Fp, Gg
Gg, Gll^Fp, Gg, Gg, Xoc, Xoc, Xoc, Xoc, Xoc, Xoc, Xoc, Gll^Fp, Gg, Gg, Gg, Gg, Gg, Gll^Fp, Xoc, Xoc, Xoc, Xoc, Xoc, Xoc, Xoc, Gg, Gll^Fp, Gg, Gg
Gg, Gg, Xoc, Xoc, Xoc, Xoc, Xoc, Xoc, Xoc, Xoc, Xos, Gg, Gg, Gg^Dr, Gg, Gg, Gg, Gg^Dr, Xoc, Xoc, Xoc, Xoc, Xoc, Xoc, Xoc, Xoc, Xoc, Gg, Gg
Xoc, Xoc, Xoc, Xoc, Xoc, Xoc, Xoc, Xoc, Xoc, Xos, Xoc, Gg, Gll^Fp, Gg, Gg^Efm, Gg, Gg, Gg, Xoc, Xos, Xoc, Xoc, Xoc, Xoc, Xoc, Xoc, Xoc, Xoc, Xoc
Xoc, Xoc, Xoc, Xoc, Xoc, Xoc, Xoc, Xoc, Xoc, Xoc, Xoc, Gll^Fp, Gg, Gg^Efm, Gg^Efm, Gll^Fp, Gll^Fp, Gll^Fp, Xoc, Xoc, Xoc, Xoc, Xoc, Xoc, Xoc, Xoc, Xoc, Xoc, Xoc
Xos, Xoc, Xoc, Xoc, Xoc, Xoc, Xoc, Xoc, Xoc, Xoc, Xoc, Gll^Fp, Gg, Gg, Gg^Efm, Gg, Gg, Gll^Fp, Xoc, Xoc, Xoc, Xoc, Xoc, Xoc, Xoc, Xoc, Xos, Xos, Xos
Xos, Xos, Xoc, Xoc, Xoc, Xoc, Xoc, Xoc, Xoc, Xoc, Xoc, Gg, Gg, Gg^Dr, Gg, Gg^Efm, Gg^Efm, Gg, Xoc, Xoc, Xoc, Xoc, Xoc, Xoc, Xoc, Xoc, Xoc, Xos, Xos
Xoc, Xoc, Xoc, Xoc, Xoc, Xoc, Xoc, Xoc, Xoc, Xoc, Gg^Efm, Gg, Gg, Gg, Gg, Gg, Gg, Gg, Gg, Xoc, Xoc, Xoc, Xoc, Xoc, Xoc, Xoc, Xoc, Xoc, Xoc
Xoc, Xoc, Xoc, Xoc, Xoc, Xoc, Xoc, Xoc, Gg^Dr, Gg^Efm, Gg^Edb, Gg, Xoc, Xoc, Gg, Xoc, Xoc, Gg, Gll^Fp, Gg, Gg, Xoc, Xoc, Xoc, Xoc, Xoc, Xoc, Xoc, Xoc
Xoc, Xoc, Xoc, Xoc, Xoc, Xoc, Gg, Gg, Gg^Efm, Gg^Efm, Gg, Gg, Gg^Dr, Cvr, Kvr, Cvr, Gg, Gg, Gll^Fp, Gll^Fp, Gg^Efm, Gg, Gg^Efm, Xoc, Xoc, Xoc, Xoc, Xoc, Xoc
Xoc, Xoc, Xoc, Xoc, Gll^Fp, Gg, Gg^Dr, Gg^Edb, Gg, Gg^Efm, Gg, Gg, Xoc, Cvr, Gg^Dr, Cvr, Xoc, Gg, Gg, Gg, Gg, Gg, Gg, Gg^Dr, Gg, Xoc, Xoc, Xoc, Xoc
Xoc, Xoc, Gll^Fp, Gll^Fp, Gg^Dr, Gg, Gg, Gg, Gg^Dr, Gg^Efm, Gg, Gg, Gg, Xoc, Gg, Xoc, Gg, Gg, Gg, Gg^Dr, Gg, Gg, Gg, Gg^Efm, Gg, Gg, Gg^Dr, Xoc, Xoc
Gg, Gll^Fp, Gg, Gll^Fp, Gg, Gg, Xoc, Xoc, Xoc, Gg, Gg, Gg^Efm, Gg, Gg, Gg^Edb, Gg, Gg, Gg, Gg^Efm, Gg, Xoc, Xoc, Xoc, Gg, Gg^Dr, Gg^Edb, Gg, Gg, Gg
Gg, Gg^Edb, Gg^Dr, Gg, Xoc, Xoc, Xoc, Xoc, Xoc, Xoc, Xoc, Gg^Edb, Gg, Gg, Gg, Gg, Gg^Efm, Gg^Efm, Xoc, Xoc, Xoc, Xoc, Xoc, Xoc, Xoc, Gg, Gg, Gg, Gll^Fp
Gg, Gg, Xoc, Xoc, Xoc, Xoc, Xoc, Xoc, Xoc, Xoc, Xoc, Xoc, Gll^Fp, Gg^Dr, Gg, Gg, Gg^Efm, Xoc, Xoc, Xoc, Xoc, Xoc, Xoc, Xoc, Xoc, Xoc, Xoc, Gll^Fp, Gll^Fp
Xoc, Xoc, Xoc, Xoc, Xoc, Xoc, Xoc, Xoc, Xoc, Xoc, Xoc, Xoc, Gll^Fp, Gg^Dr, Gg, Gg, Gg, Xoc, Xoc, Xoc, Xoc, Xoc, Xoc, Xoc, Xoc, Xoc, Xoc, Xoc, Xoc
Xoc, Xoc, Xoc, Xoc, Xoc, Xoc, Xoc, Xoc, Xoc, Xoc, Xoc, Xoc, Gll^Fp, Gll^Fp, Gg, Gg, Gg^Dr, Xoc, Xoc, Xoc, Xoc, Xoc, Xoc, Xoc, Xoc, Xoc, Xoc, Xoc, Xoc
Xoc, Xoc, Xoc, Xoc, Xoc, Xoc, Xoc, Xoc, Xoc, Xoc, Xoc, Xoc, Gll^Fp, Gg, Gg, Gg, Gg, Xoc, Xoc, Xoc, Xoc, Xoc, Xoc, Xoc, Xoc, Xoc, Xoc, Xoc, Xoc
Xoc, Xoc, Xoc, Xoc, Xoc, Xoc, Xoc, Xoc, Xoc, Xoc, Xoc, Xoc, Gg, Gg, Gg, Gg, Gg^Dr, Xoc, Xoc, Xoc, Xoc, Xoc, Xoc, Xoc, Xoc, Xoc, Xoc, Xoc, Xoc
Xoc, Xoc, Xoc, Xoc, Xoc, Xoc, Xoc, Xoc, Xoc, Xoc, Gg^Dr, Gg, Gg, Gg, Gg, Gg, Gg, Gg, Gg^Dr, Xoc, Xoc, Xoc, Xoc, Xoc, Xoc, Xoc, Xoc, Xoc, Xoc
Xoc, Xoc, Xoc, Xoc, Xoc, Xoc, Xoc, Xoc, Gg^Dr, Gg, Gg, Gg, Gg, Gg^Efm, Gg, Gg, Gg^Efm, Gg, Gg, Gg^Efm, Gll^Fp, Xoc, Xoc, Xoc, Xoc, Xoc, Xoc, Xoc, Xoc
Xoc, Xoc, Xoc, Xoc, Xoc, Xoc, Gg, Gg, Gg, Gg, Gg, Gg^Dr, Gg, Gg, Gg, Gg, Gg, Gg, Gg, Gg^Efm, Gg, Gll^Fp, Gll^Fp, Xoc, Xoc, Xoc, Xoc, Xoc, Xoc
Xoc, Xoc, Xoc, Xoc, Gg, Gg, Gg^Dr, Gg, Gll^Fp, Gll^Fp, Xoc, Xoc, Gg, Gg^Edb, Gg, Gg, Gg^Dr, Xoc, Xoc, Gg, Gg, Gg, Gg^Dr, Gll^Fp, Gg, Xoc, Xoc, Xoc, Xoc
Xoc, Xoc, Gll^Fp, Gll^Fp, Gg, Gg, Gg, Gg, Xoc, Xoc, Xoc, Xoc, Gg, Gg, Gg, Gg, Gll^Fp, Xoc, Xoc, Xoc, Xoc, Gg, Gg, Gg, Gg^Efm, Gg^Efm, Gg^Efm, Xoc, Xoc
Gg, Gll^Fp, Gg^Dr, Gll^Fp, Gg, Gg^Dr, Xoc, Xoc, Xoc, Xoc, Xoc, Xoc, Gg^Dr, Gg, Gg^Dr, Gg, Gg, Xoc, Xoc, Xoc, Xoc, Xoc, Xoc, Gg^Efm, Gg, Gg^Efm, Gg, Gg^Edb, Gg
Gg, Gg, Gg, Gg, Xoc, Xoc, Xoc, Xoc, Xoc, Xoc, Xoc, Xoc, Gg^Dr, Gg, Gg, Gg^Edb, Gg, Xoc, Xoc, Xoc, Xoc, Xoc, Xoc, Xoc, Xoc, Gg, Gg, Gg, Gg
Gg, Gg^Edb, Xoc, Xoc, Xoc, Xoc, Xoc, Xoc, Xoc, Xoc, Xoc, Xoc, Gg, Gg^Dr, Gg^Dr, Gg^Dr, Gg^Dr, Xoc, Xoc, Xoc, Xoc, Xoc, Xoc, Xoc, Xoc, Xoc, Xoc, Gg, Gg
Xoc, Xoc, Xoc, Xoc, Xoc, Xoc, Xoc, Xoc, Xoc, Xoc, Xoc, Xoc, Gg^Dr, Gg^Dr, Gg, Gg^Dr, Gg^Dr, Xoc, Xoc, Xoc, Xoc, Xoc, Xoc, Xoc, Xoc, Xoc, Xoc, Xoc, Xoc
