Wo, Wo, Wo, Wo, Wo, Wo, Wo, Wo, Wo, Wo, Wo, Wo, Wo, Wo, Wo, Wo, Wo, Wo, Wo, Wo, Wo, Wo, Wo, Wo, Wo, Wo, Wo, Wo, Wo, Wo, Wo, Wo, Wo, Wo, Wo, Wo, Wo, Wo, Ww, Ww, Ww, Ww, Ww, Ww, Ww, Ww, Ww, Ww, Gg^_fme, Gg^_fme, Gg^_fme, Gg^_fme, Gg^_fme, Gg^_fme
Wo, Wo, Wo, Wo, Wo, Wo, Wo, Wo, Wo, Wo, Wo, Wo, Wo, Wo, Wo, Wo, Wo, Wo, Wo, Wo, Wo, Wo, Wo, Wo, Wo, Wo, Wo, Wo, Wo, Wo, Wo, Wo, Wo, Wo, Wo, Wo, Ww, Ww, Ww, Ww, Ww, Ww, Ww, Ww, Gg, Ww, Gg, Gg, Gg^_fme, Gg^_fme, Gg^_fme, Gg^_fme, Gg^_fme, Gg^_fme
Wo, Wo, Wo, Wo, Wo, Wo, Wo, Wo, Wo, Wo, Wo, Wo, Wo, Wo, Wo, Wo, Wo, Wo, Wo, Wo, Wo, Wo, Wo, Wo, Wo, Wo, Wo, Wo, Wo, Wo, Wo, Wo, Ww, Wo, Ww, Ww, Ce, Ww, Ce, Ke, Gg, Gg, Gg, Gg, Gg, Gs^Fms, Gs^Fms, Gg, Gg^_fme, Gg^_fme, Ce^_fme, Gg^_fme, Gg^_fme, Gg^_fme
Wo, Wo, Wo, Wo, Wo, Wo, Wo, Wo, Wo, Wo, Wo, Wo, Wo, Wo, Wo, Wo, Wo, Wo, Wo, Wo, Wo, Wo, Wo, Wo, Wo, Wo, Wo, Wo, Wo, Wo, Ww, Ww, Gg, Ww, Gg, Ce, Ce, Ce, Ce, Re^Vct, Gg, Re, Re, Gg, Gg, Gs^Fms, Gg, Gg, Gg^_fme, Ce^_fme, Ce^_fme, Re^_fme, Gg^_fme, Gg^_fme
Wo, Wo, Wo, Wo, Wo, Wo, Wo, Wo, Wo, Wo, Wo, Wo, Wo, Wo, Wo, Wo, Wo, Wo, Wo, Wo, Wo, Wo, Wo, Wo, Wo, Wo, Ww, Ww, Ww, Ww, Gg, Gg, Gg, Gg, Gg, Re^Vct, Gg, Ce, Gg, Gg, Re^Vct, Gg, Gg, Rr, Rr, Rr, Rr, Re, Gg^_fme, Ce^_fme, Ce^_fme, Ce^_fme, Gg^_fme, Gg^_fme
Wo, Wo, Wo, Wo, Wo, Wo, Wo, Wo, Wo, Wo, Wo, Wo, Wo, Wo, Wo, Wo, Wo, Wo, Wo, Wo, Wo, Wo, Wo, Wo, Ww, Ww, Gg, Gg, Gg, Gg, Gs^Fms, Gs^Fms, Gg, Gg, Re, Gg, Re, Re, Ce, Ce, Ke, Ce, Ce, Gg, Gg, Gg, Gg, Gg, Gg^_fme, Ce^_fme, Ke^_fme, Ce^_fme, Gg^_fme, Gg^_fme
Wo, Wo, Wo, Wo, Wo, Wo, Wo, Wo, Wo, Wo, Wo, Wo, Wo, Wo, Wo, Wo, Wo, Wo, Wo, Wo, Ww, Wo, Ww, Ww, Gg, Gs^Fms, Gg, Gg, Gg, Gg, Gg, Gg, Rr, Rr, Gg, Re, Gg, Gg, Gg, Ce, Ce, Ce, Gg, Gg, Gg, Gg, Gs^Fms, Gg, Gg^_fme, Ce^_fme, Ce^_fme, Ce^_fme, Gg^_fme, Gg^_fme
Wo, Wo, Wo, Wo, Wo, Wo, Wo, Wo, Wo, Wo, Wo, Wo, Wo, Wo, Wo, Wo, Wo, Wo, Ww, Ww, Gd^Vhr, Ww, Gg, Gg, Gg, Gs^Fms, Gs^Fms, Gg, Rr, Rr, Gg, Re, Gg, Gg, Gs^Fms, Gg, Gs^Fms, Gg, Gg, Re^Vct, Gg, Gg, Gg, Gg, Mm, Gg, Gg, Gs^Fms, Gg^_fme, Re^_fme, Ce^_fme, Ce^_fme, Gg^_fme, Gg^_fme
Wo, Wo, Wo, Wo, Wo, Wo, Wo, Wo, Wo, Wo, Wo, Wo, Wo, Wo, Ww, Wo, Ww, Ww, Gg, Gg, Gg, Gg, Gg, Gg, Re, Gg, Re, Re, Gg, Rr, Gg, Gg, Gg, Gg, Gg, Gs^Fms, Gg, Gg, Gg, Gg, Gg, Gg, Mm, Mm, Mm, Mm, Mm, Gg, Mm^_fme, Gg^_fme, Mm^_fme, Gg^_fme, Mm^_fme, Gg^_fme
Wo, Wo, Wo, Wo, Wo, Wo, Wo, Wo, Wo, Wo, Wo, Wo, Ww, Ww, Gg, Ww, Gg, Gg, Gg, Gg, Gg, Gg, Rr, Rr, Gs^Fms, Gg, Gg, Gg, Gd^Vhr, Gs^Fms, Gg, Gg, Gg, Gg, Gg, Gg, Gg, Gg, Gg, Gg, Gs^Fms, Mm, Mm, Mm, Mm, Mm, Mm, Mm, Mm^_fme, Mm^_fme, Mm^_fme, Mm^_fme, Mm^_fme, Mm^_fme
Wo, Wo, Wo, Wo, Wo, Wo, Wo, Wo, Wo, Wo, Ww, Ww, Gg, Gg, Gg, Gg, Gg, Gs^Fms, Gs^Fms, Gg, Rr, Gg, Gg, Gg, Gg, Gg, Gg, Gg, Gg, Gg, Gg, Gg, Gg, Gg, Gg, Gg, Gs^Fms, Gs^Fms, Gs^Fms, Gs^Fms, Mm, Mm, Mm, Mm, Mm, Mm, Mm, Mm, Mm^_fme, Mm^_fme, Mm^_fme, Mm^_fme, Mm^_fme, Mm^_fme
Wo, Wo, Wo, Wo, Wo, Wo, Wo, Wo, Ww, Ww, Gg, Gg, Gg, Gs^Fms, Gg, Gg, Gg, Gg, Gg, Gg, Re, Gg, Gs^Fms, Gs^Fms, Gg, Gg, Gg, Gg, Gg, Gs^Fms, Gs^Fms, Gg, Gs^Fms, Gg, Gg, Gg, Mm, Mm, Mm, Mm, Mm, Mm, Mm, Mm, Mm, Mm, Mm, Mm, Mm^_fme, Mm^_fme, Mm^_fme, Mm^_fme, Mm^_fme, Mm^_fme
Wo, Wo, Wo, Wo, Wo, Wo, Ww, Ww, Gg, Gs^Fms, Gs^Fms, Gg, Gs^Fms, Gs^Fms, Gg, Gg, Gg, Gg, Rr, Gg, Gg, Gg, Gg, Gg, Gg, Gg, Gs^Fms, Gg, Gg, Gg, Mm, Gs^Fms, Gs^Fms, Gs^Fms, Mm, Mm, Mm, Mm, Mm, Mm, Mm, Mm, Mm, Mm, Mm, Mm, Mm, Mm, Mm^_fme, Mm^_fme, Mm^_fme, Mm^_fme, Mm^_fme, Mm^_fme
Wo, Wo, Wo, Wo, Ww, Chw, Chw, Ww, Chr, Gg, Gg, Gg, Gg, Gs^Fms, Gg, Gg, Rr, Rr, Gg, Gg, Gg, Gg, Gg, Gg, Gg, Gs^Fms, Gs^Fms, Gs^Fms, Gg, Mm, Mm, Mm, Mm, Mm, Mm, Mm, Mm, Mm, Mm, Mm, Mm, Mm^Xm, Mm, Mm, Mm, Mm, Mm, Mm, Mm^_fme, Mm^_fme, Mm^_fme, Mm^_fme, Mm^_fme, Mm^_fme
Wo, Wo, Ww, Ww, Ww, Ww, Rr, Ce, Ket, Chr, Chr, Gg, Gg, Gg, Gg, Gg, Rr, Gg, Gg, Gg, Gg, Gg, Gg, Gg, Gg, Gs^Fms, Gg, Gs^Fms, Gg, Gg, Mm, Mm, Mm, Mm, Mm, Mm, Mm, Mm, Mm^Xm, Mm, Mm, Mm, Mm, Mm, Mm, Mm, Mm, Mm, Mm^_fme, Mm^_fme, Mm^_fme, Mm^_fme, Mm^_fme, Mm^_fme
Wo, Wo, Ww, Ww, Ww^Bw/, Ww^Bw/, Rr, Re^Vct, Gg, Rp^Vhcr, Rr^Dr, Gg, Gg, Gg, Gg, Rr, Gg, Gg, Gg, Gg, Gg, Gg, Gg, Gg, Mm, Gg, Hhd^Vhhr, Gg, Gs^Fms, Gs^Fms, Mm, Mm, Mm, Mm, Mm, Mm, Mm, Mm, Mm, Mm, Mm, Mm, Mm, Mm^Xm, Mm, Mm, Mm, Mm, Mm^_fme, Mm^_fme, Mm^_fme, Mm^_fme, Mm^_fme, Mm^_fme
Wo, Wo, Ww, Ww^Bw/, Ww, Ww, Rr, Re, Re, Khr, Re, Chr, Gg, Gg, Re, Gg, Gg, Gg, Gg, Gg, Gg, Gg, Mm, Mm, Mm, Mm, Mm, Mm, Mm, Mm, Mm, Mm, Mm, Mm, Mm, Mm, Mm, Mm, Mm, Mm, Mm, Mm, Mm, Mm, Mm, Mm, Mm, Mm, Mm^_fme, Mm^_fme, Mm^_fme, Mm^_fme, Mm^_fme, Mm^_fme
Wo, Wo, Ww, Ww, Ww^Bw/, Ww^Bw/, Rr, Rp^Vhcr, Rr, Gg, Re^Vct, Rr, Rr, Gg, Rr, Gg, Gs^Fms, Gg, Gg, Gg, Mm, Mm, Mm, Mm, Mm, Mm, Mm, Mm, Mm, Mm, Mm, Mm, Mm, Mm, Mm, Mm, Mm, Mm, Mm, Mm^Xm, Mm, Mm^Xm, Mm, Mm, Mm, Mm, Mm, Mm, Mm^_fme, Mm^_fme, Mm^_fme, Mm^_fme, Mm^_fme, Mm^_fme
Wo, Wo, Ww, Ww^Bw/, Ww, Ww, Rr, Rr, Re, Khr, Ce, Ce, Gg, Re, Gg, Gg, Gs^Fms, Gg, Gg, Mm, Mm, Mm, Mm, Mm, Mm, Mm, Mm, Mm, Mm, Mm, Mm, Mm, Mm, Mm, Mm^Xm, Mm, Mm, Mm, Mm, Mm, Mm, Mm, Mm, Mm, Mm, Mm, Mm, Mm, Mm^_fme, Mm^_fme, Mm^_fme, Mm^_fme, Mm^_fme, Mm^_fme
Wo, Wo, Ww, Ww, Ww^Bw/, Ww^Bw/, Rr, Re, Rp^Vhcr, Re, Chr, Gg, Rr, Rr, Gg, Gg, Gg, Gg, Mm, Mm, Mm, Mm, Mm, Mm, Mm, Mm, Mm, Mm, Mm, Mm, Mm, Mm^Xm, Mm, Mm, Mm, Mm, Mm, Mm, Mm, Mm, Mm, Mm, Mm, Mm, Mm, Mm, Mm, Mm, Mm^_fme, Mm^_fme, Mm^_fme, Mm^_fme, Mm^_fme, Mm^_fme
Wo, Wo, Ww, Ww^Bw/, Ww, Ww, Wwr, Chr, Chr, Chr, Gg, Gg, Rr, Gg, Gs^Fms, Gg, Gg, Gg, Hhd^Vhhr, Mm, Mm, Mm, Mm, Mm, Mm, Mm, Mm, Mm, Mm, Mm, Mm^Xm, Mm, Mm, Mm, Mm, Mm, Mm, Mm, Mm, Mm, Mm, Mm, Mm, Mm, Mm, Mm, Mm, Mm, Mm^_fme, Mm^_fme, Mm^_fme, Mm^_fme, Mm^_fme, Mm^_fme
Wo, Wo, Wo, Ww, Ww, Chw, Ww, Ww, Gg, Gg, Gs^Fms, Gg, Gg, Gg, Gs^Fms, Gg, Gg, Gg, Mm, Mm, Mm, Mm, Mm, Mm^Xm, Mm, Mm, Mm, Mm, Mm, Mm, Mm, Mm, Mm, Mm, Mm, Mm, Mm, Mm, Mm, Mm, Mm, Mm, Mm, Mm, Mm, Mm, Mm, Mm, Mm^_fme, Mm^_fme, Mm^_fme, Mm^_fme, Mm^_fme, Mm^_fme
Wo, Wo, Wo, Wo, Wo, Ww, Ww, Ww, Gg, Gs^Fms, Gs^Fms, Gg, Re, Gg, Gg, Gg, Gg, Gg, Mm, Mm, Mm, Mm, Mm, Mm, Mm, Mm, Mm, Mm, Mm, Mm, Mm, Mm, Mm, Mm, Mm, Mm, Mm, Mm, Mm, Mm, Mm, Mm, Mm, Mm, Mm, Mm, Mm, Mm, Mm^_fme, Mm^_fme, Mm^_fme, Mm^_fme, Mm^_fme, Mm^_fme
Wo, Wo, Wo, Wo, Wo, Wo, Wo, Ww, Gg, Gg, Gg, Gg, Re, Gg, Gg, Gg, Gg, Gg, Mm, Mm, Mm, Mm, Mm, Mm, Mm, Mm, Gg, Mm, Mm, Mm, Mm, Mm, Mm, Mm, Mm, Mm, Mm, Mm, Mm, Mm, Mm, Mm, Mm, Mm, Mm, Mm, Mm, Mm, Mm^_fme, Mm^_fme, Mm^_fme, Mm^_fme, Mm^_fme, Mm^_fme
