Xue, Xue, Xue, Xue, Xue, Uue, Uue, Uue, Uue, Uue, Uue, Uue, Uue, Uue, Xue, Xue, Xue, Xue, Xue
Xue, Xue, Re^Vct, Re^Vct, Uue, Uue, Uue^Ii, Uue, Uue, Uue, Uue, Re^Ii, Re^Vct, Uue, Uue, Xue, Uu^Vu, Xue, Xue
Xue, Uu^Vu, Uue, Uue, Uue, Uue, Uue, Uue, Uue, Uue, Uue, Uue, Uue, Re^Vct, Uue, Uue, Uue, Uue, Xue
Xue, Xue, Uue, Uue, Uue, Uue, Uue, Uue, Uue, Uue, Uue, Uue, Uue, Uue, Uue, Uue, Uue, Uue, Xue
Xue, Uue^Ii, Uue, Uue, Uue, Uue, Uue, Uue, Uue, Uue, Uue, Uue, Uue, Uue, Uue, Uue, Uue, Uue^Ii, Xue
Xue, Xue, Uue, Uue, Uue, Uue, Uue, Uue, Uue, Uue, Uue^Ii, Uue, Uue, Uue, Uue, Uue, Uue, Uue, Xue
Xue, Xue, Xue, Uue, Uue, Re^Vct, Re^Vct, Uue, Uue, Uue, Uue, Uue, Xue, Xue, Uue, Uue, Uue, Xue, Xue
Xue, Xue, Xue, Xue, Xue, Uue, Uue, Uue, Uue, Uue, Uue, Uue, Xue, Uue, Uue, Uue, Xue, Xue, Xue
Xue, Xue, Xue, Xue, Xue, Xue, Xue, Uue, Uu^Vu, Uue, Xue, Xue, Uue, Uue, Xue, Xue, Xue, Xue, Xue
Xue, Xue, Xue, Xue, Xue, Xue, Xue, Xue, Xue, Xue, Uue, Uue, Xue, Xue, Xue, Xue, Xue, Xue, Xue
Xue, Xue, Xue, Xue, Xue, Xue, Xue, Xue, Uue^Ii, Uue, Xue, Xue, Xue, Xue, Xue, Xue, Xue, Xue, Xue
Xue, Xue, Xue, Xue, Xue, Xue, Gg, Gg, Xue, Xue, Xue, Xue, Xue, Xue, Xue, Xue, Xue, Xue, Xue
