Gg, Gll^Fp, Gll^Fp, Gg, Gg, Gll^Fp, Gg, Gll^Fp, Gll^Fp, Gll^Fp, Gll^Fp, Gg, Gg, Gg, Gll^Fp, Gg, Gg, Gll^Fp, Gg, Gll^Fp, Gll^Fp, Gll^Fp, Gll^Fp, Gll^Fp, Gll^Fp, Gll^Fp, Gg, Gll^Fp, Gll^Fp, Gll^Fp
Gll^Fp, Gll^Fp, Gg, Gg, Gll^Fp, Gll^Fp, Ke, Ce, Ce, Gg, Gll^Fp, Gll^Fp, Gg, Gll^Fp, Gll^Fp, Gll^Fp, Gll^Fp, Gll^Fp, Gll^Fp, Gg, Gg, Gll^Fp, Gg, Gll^Fp, Gg, Gg, Gg, Gg, Gg, Gll^Fp
Gll^Fp, Gll^Fp, Gg, Gll^Fp, Ke, Gll^Fp, Re^Vct, Ce, Gg, Gg, Gll^Fp, Gll^Fp, Gll^Fp, Gg, Gg, Gll^Fp, Gll^Fp, Gll^Fp, Gll^Fp, Gll^Fp, Gll^Fp, Gg, Gll^Fp, Gg, Gll^Fp, Gg^Ve, Gll^Fp, Gll^Fp, Gll^Fp, Gll^Fp
Gg, Gll^Fp, Gg, Ce, Ce, Ce, Gg, Gll^Fp, Gll^Fp, Gg, Gll^Fp, Gg, Gg, Gll^Fp, Gg, Gll^Fp, Gg, Gll^Fp, Gg, Gll^Fp, Gll^Fp, Gll^Fp, Gg, Gg, Gll^Fp, Gll^Fp, Gll^Fp, Gll^Fp, Gll^Fp, Gll^Fp
Gll^Fp, Gg, Gll^Fp, Gg, Gg, Gg, Gll^Fp, Gg, Gg, Gll^Fp, Gll^Fp, Gll^Fp, Gg, Gll^Fp, Gll^Fp, Gg, Gg, Gg, Gg, Gll^Fp, Gll^Fp, Gg, Gll^Fp, Gg, Gll^Fp, Gll^Fp, Gg, Gll^Fp, Gg, Gg
Gll^Fp, Gll^Fp, Gll^Fp, Gg, Gg, Gg, Gll^Fp, Gll^Fp, Gll^Fp, Gll^Fp, Gll^Fp, Gg, Gg^Ve, Gg, Gg^Dr, Gg, Rr, Gll^Fp, Gll^Fp, Gg, Gg, Gll^Fp, Gg, Gg, Gll^Fp, Gll^Fp, Gg, Gg, Ds, Ds
Gll^Fp, Gll^Fp, Gll^Fp, Gg, Gg, Gg, Gll^Fp, Gg, Gll^Fp, Gll^Fp, Gg, Gll^Fp, Gg, Cvr, Gg^Dr, Cvr, Rr, Gg, Gg, Gg, Gg, Gg, Gll^Fp, Gg, Gg, Gg, Ds, Ds, Ww, Ww
Gg, Gg, Gll^Fp, Gll^Fp, Gg, Gg, Gg, Gg, Gll^Fp, Gg, Gg, Gll^Fp, Rr, Cvr, Rr, Rr, Gg, Gg, Gg^Dr, Gg^Dr, Cvr, Gg, Gg, Gg, Ds, Ds, Ww, Ww, Wo, Wo
Gll^Fp, Gg, Gg, Gg, Gll^Fp, Gll^Fp, Gg, Gll^Fp, Gll^Fp, Gll^Fp, Gg, Gg, Gg, Rr, Gg, Rr, Gg, Cvr, Gg^Ve, Gg, Gg, Cvr, Cv, Ds, Ww, Ww, Wo, Wo, Wo, Wo
Gll^Fp, Gg, Gg, Gll^Fp, Gg, Gg, Gg, Gg, Gg, Gg, Gg, Gg, Gg, Gg, Gg^Dr, Gg, Rr, Gg, Gg, Gg, Gg, Gg^Ve, Rrc, Cv, Kvr, Ww, Wo, Wo, Wo, Wo
Gg, Gg^Ve, Gg, Gg, Gg, Gg, Gll^Fp, Gll^Fp, Gg, Gg, Gll^Fp, Gll^Fp, Gg, Cvr, Gg^Ve, Gg, Rr, Gll^Fdw, Gll^Fp, Gll^Fdw, Rr, Rrc, Ww^Bw\, Ww, Ww, Ww, Wo, Wo, Wo, Wo
Gll^Fp, Gll^Fp, Gll^Fp, Gg, Gll^Fp, Gg, Gll^Fp, Gll^Fp, Gg, Gg, Gg, Gg, Gg, Cvr, Cvr, Gg, Gg, Rr, Rrc, Rr, Ww, Ww, Ww, Ww^Bw\, Ww^Bw\, Ww, Wo, Wo, Wo, Wo
Gll^Fp, Gll^Fp, Gll^Fp, Gg, Gll^Fp, Gll^Fp, Gg, Gll^Fp, Gg, Gg, Gll^Fp, Gll^Fp, Gll^Fp, Gg, Ds, Cv, Cvr, Rrc, Ww, Ww^Bw\, Ww^Bw\, Ww, Ww, Ww, Ww, Ww, Wo, Wo, Wo, Wo
Gg, Gll^Fp, Gll^Fp, Gg, Gg, Gll^Fp, Gll^Fp, Gll^Fp, Gg, Gll^Fp, Gll^Fp, Gll^Fp, Ds, Ds, Ww, Ww, Ww, Kv, Ww, Ww, Ww, Ww^Bw\, Ww, Ww, Wo, Wo, Wo, Wo, Wo, Wo
Gg, Gg, Gll^Fp, Gll^Fp, Gg, Gll^Fp, Gll^Fp, Gg, Gg, Gg, Ds, Ds, Ww, Ww, Wo, Wo, Wo, Ww, Wo, Wo, Wo, Ww, Wo, Wo, Wo, Wo, Wo, Wo, Wo, Wo
