Gll^Fp, Gll^Fp, Gll^Fp, Gll^Fp, Gg, Gll^Fp, Gll^Fp, Gll^Fp, Gg, Gll^Fp, Gll^Fp, Gll^Fp, Gll^Fp, Gll^Fp, Gll^Fp, Gll^Fp, Gll^Fp, Gll^Fp, Gll^Fp, Gll^Fp, Gll^Fp, Gll^Fp, Gll^Fp, Gll^Fp, Gll^Fp, Gll^Fp, Gll^Fp, Gll^Fp, Gll^Fp, Gll^Fp, Ww, Ww, Wo, Wo
Gll^Fp, Gll^Fp, Gg^Ve, Gll^Fp, Gg, Gg, Gg, Gll^Fp, Gll^Fp, Gll^Fp, Gg, Gll^Fp, Gg, Gll^Fp, Gll^Fp, Gg, Gll^Fp, Gg, Gg, Gg, Re^Vct, Ce, Ce, Ke, Gg, Gg, Gg, Gll^Fp, Ww, Ww, Wo, Wo, Wo, Wo
Gll^Fp, Gll^Fp, Gg, Gll^Fp, Gll^Fp, Gg, Gll^Fp, Gg, Gll^Fp, Gg^Ve, Gll^Fp, Gll^Fp, Gll^Fp, Gg, Gll^Fp, Gg, Gg, Gll^Fp, Gg, Gg, Gll^Fp, Ce, Ce, Ce, Gg, Gg, Ww, Ww, Wo, Wo, Wo, Wo, Wo, Wo
Gg, Gll^Fp, Gll^Fp, Gg, Gll^Fp, Gll^Fp, Gll^Fp, Gll^Fp, Gg, Gll^Fp, Gll^Fp, Gg, Gll^Fp, Gg, Gg, Gll^Fp, Gll^Fp, Gg, Gll^Fp, Gg, Gll^Fp, Gll^Fp, Gll^Fp, Gg, Ww, Ww, Wo, Wo, Wo, Wo, Wo, Wo, Wo, Wo
Gg, Gg, Gg, Gll^Fp, Gg, Gg, Gll^Fp, Gll^Fp, Gll^Fp, Gg, Gll^Fp, Gg, Gg, Gll^Fp, Gll^Fp, Gg, Gll^Fp, Gll^Fp, Ww, Gll^Fp, Ww, Ww, Ww, Ww, Wo, Wo, Wo, Wo, Wo, Wo, Wo, Wo, Wo, Wo
Gll^Fp, Gg, Gll^Fp, Gg, Gg, Gll^Fp, Rr^Dr, Cvr, Cv, Gg, Gll^Fp, Gg, Ww, Gll^Fp, Ww, Ww, Ww, Ww, Ww, Ww, Wo, Ww, Wo, Wo, Wo, Wo, Wo, Wo, Wo, Wo, Wo, Wo, Wo, Wo
Gll^Fp, Gll^Fp, Gg, Gll^Fp, Cv, Gg, Gg, Gg^Ve, Gll^Fp, Rr, Cv, Ww, Ww, Ww, Ww, Ww, Wo, Ww, Wo, Wo, Wo, Wo, Wo, Wo, Wo, Wo, Wo, Wo, Wo, Wo, Wo, Wo, Wo, Wo
Gll^Fp, Gll^Fp, Gg, Cvr, Cvr, Kv, Gll^Fp, Gg, Rrc, Rrc, Ww^Bsb\, Cvr, Wo, Wo, Wo, Wo, Wo, Wo, Wo, Wo, Wo, Wo, Wo, Wo, Wo, Wo, Wo, Wo, Wo, Wo, Wo, Wo, Ww, Ww
Gg, Gg, Gll^Fp, Gll^Fp, Gll^Fp, Cv, Cv, Rrc, Ww^Bsb\, Ww^Bsb\, Ww^Bsb\, Ww^Bsb\, Ww^Bsb\, Wo, Wo, Wo, Wo, Wo, Wo, Wo, Wo, Wo, Wo, Wo, Wo, Wo, Wo, Wo, Wo, Wo, Ww, Ww, Ds, Ds
Gll^Fp, Gg^Ve, Gll^Fp, Gll^Fp, Ww, Ww, Ww, Cvr, Wo, Ww^Bsb\, Ww^Bsb\, Ww^Bsb\, Ww^Bsb\, Ww^Bsb\, Cvr, Wo, Wo, Wo, Wo, Wo, Wo, Wo, Wo, Wo, Wo, Wo, Wo, Wo, Ww, Ww, Ds, Ds, Ke, Re^Vct
Gg, Gll^Fp, Gg, Gll^Fp, Ww, Ww, Wo, Wo, Wo, Wo, Wo, Ww^Bsb\, Cvr, Cv, Gg^Fet, Kvr, Cv, Wo, Wo, Wo, Wo, Wo, Wo, Wo, Wo, Wo, Ww, Ww, Ds, Ds, Ce, Ce, Ce, Gg
Gll^Fp, Gg, Gg, Gll^Fp, Ww, Wo, Wo, Wo, Wo, Wo, Wo, Wo, Wo, Gg^Ve, Cvr, Cv, Ww^Bsb\, Ww^Bsb\, Ww^Bsb\, Wo, Wo, Wo, Wo, Wo, Ww, Ww, Gll^Fp, Ds, Gll^Fp, Gll^Fp, Gll^Fp, Ce, Ce, Gll^Fp
Gll^Fp, Gll^Fp, Ww, Ww, Wo, Wo, Wo, Wo, Wo, Wo, Wo, Wo, Wo, Wo, Wo, Ww^Bsb\, Ww^Bsb\, Ww^Bsb\, Ww^Bsb\, Ww^Bsb\, Ww^Bsb\, Cvr, Cv, Ww, Gll^Fp, Gll^Fp, Gll^Fp, Gll^Fp, Gll^Fp, Gll^Fp, Gg, Re^Vct, Gll^Fp, Gll^Fp
Ww, Ww, Wo, Wo, Wo, Wo, Wo, Wo, Wo, Wo, Wo, Wo, Wo, Wo, Wo, Wo, Wo, Ww^Bsb\, Ww^Bsb\, Ww^Bsb\, Rrc, Rrc, Gg, Cvr, Cv, Gll^Fp, Gll^Fp, Gll^Fp, Gg, Gg, Gg, Gg, Gll^Fp, Gll^Fp
Wo, Wo, Wo, Wo, Wo, Wo, Wo, Wo, Wo, Wo, Wo, Wo, Wo, Wo, Wo, Wo, Ww, Cvr, Rr, Rrc, Gg, Gg, Gg, Kvr, Cv, Cvr, Gg, Gg, Gg, Gll^Fp, Gg, Gg, Gll^Fp, Gll^Fp
Wo, Wo, Wo, Wo, Wo, Wo, Wo, Wo, Wo, Wo, Wo, Wo, Wo, Wo, Ww, Ww, Ww, Ww, Gll^Fp, Cvr, Cv, Gg^Ve, Cvr, Gg, Gg, Gll^Fp, Gll^Fp, Gll^Fp, Gll^Fp, Gg, Gg, Gg, Gll^Fp, Gll^Fp
Wo, Wo, Wo, Wo, Wo, Wo, Wo, Wo, Wo, Wo, Wo, Wo, Ww, Ww, Gll^Fp, Gll^Fp, Gll^Fp, Gg, Gll^Fp, Gll^Fp, Gg, Rr^Dr, Gll^Fp, Gg, Gll^Fp, Gg, Gll^Fp, Gg, Gll^Fp, Gll^Fp, Gg, Gll^Fp, Gll^Fp, Gll^Fp
Wo, Wo, Wo, Wo, Wo, Wo, Wo, Wo, Wo, Wo, Ww, Ww, Gll^Fp, Gll^Fp, Gll^Fp, Gll^Fp, Gg, Gll^Fp, Gll^Fp, Gll^Fp, Gll^Fp, Gg, Gll^Fp, Gg, Gg, Gg^Ve, Gg, Gll^Fp, Gg, Gll^Fp, Gll^Fp, Gg, Gll^Fp, Gll^Fp
Wo, Wo, Wo, Wo, Wo, Wo, Wo, Wo, Ww, Ww, Gll^Fp, Gll^Fp, Gg, Gll^Fp, Gg^Ve, Gg, Gg, Gll^Fp, Gg, Gll^Fp, Gg, Gll^Fp, Gg, Gll^Fp, Gll^Fp, Gll^Fp, Gll^Fp, Gll^Fp, Gg, Gg, Gg, Gg, Gll^Fp, Gll^Fp
Wo, Wo, Ww, Ww, Ww, Wo, Ww, Ww, Gg, Gll^Fp, Gg, Gll^Fp, Gll^Fp, Gg, Gg, Gll^Fp, Gg, Gg, Gll^Fp, Gg, Gll^Fp, Gll^Fp, Gg, Gll^Fp, Gg, Gll^Fp, Gll^Fp, Gg, Gll^Fp, Gll^Fp, Gll^Fp, Gll^Fp, Gll^Fp, Gll^Fp
Ww, Ww, Gg, Gll^Fp, Ww, Ww, Gg, Gll^Fp, Gll^Fp, Gll^Fp, Gll^Fp, Gll^Fp, Gg, Gg, Gll^Fp, Gg, Gll^Fp, Gg, Gll^Fp, Gg, Gll^Fp, Gll^Fp, Gll^Fp, Gll^Fp, Gll^Fp, Gll^Fp, Gll^Fp, Gg, Gll^Fp, Gg, Gll^Fp, Gg^Ve, Gll^Fp, Gll^Fp
