Rrc, Gg, Gs^Fms, Gg, Gg, Gg, Gg, Gg, Gg, Rrc, Gg, Gg, Gg, Gg, Gg, Gs^Fds, Gs^Fds, Gg, Gs^Fds, Gg, Gg, Gg, Gs^Fds, Gs^Fds, Gs^Fds, Gs^Fds, Gs^Fds, Gg, Gs^Fds, Gg, Gs^Fds, Gs^Fds, Gg, Gg, Gs^Fds, Gg, Gg, Gg, Re, Rrc, Ds, Ds, Ww, Ww, Wo, Wo, Wo
Gs^Fms, Rrc, Rrc, Gg, Gs^Fms, Gs^Fms, Ce, Gs^Fms, Gg, Gg, Gs^Fms, Gg, Gs^Fms, Gg, Gs^Fds, Gg, Gs^Fds, Gs^Fds, Gg, Gg, Gs^Fds, Gg, Gs^Fds, Gg, Gg, Gg, Gs^Fms, Gg, Gg, Gs^Fds, Gs^Fms, Gs^Fds, Gs^Fds, Gg, Gs^Fds, Gg, Ce, Gg, Re, Ds, Ds, Ds, Ww, Ww, Wo, Wo, Wo
Gg, Gg, Ce, Rrc, Re, Re^Vct, Ce, Ke, Gs^Fms, Gg, Gg, Gg, Gg, Gg, Gs^Fds, Gg, Gg, Gg, Gs^Fds, Gs^Fds, Gg, Gg, Gg, Gs^Fds, Gg, Gs^Fds, Gg, Gs^Fms, Gs^Fds, Gg, Gs^Fds, Gg, Ce, Gg, Gg, Ce, Gs^Fds, Ce, Re, Ds, Ds, Ds, Ww, Ww, Wo, Wo, Wo
Gg, Ke, Ce, Ce, Gg, Re, Re, Ce, Gg, Gs^Fds, Gg, Gs^Fms, Gg, Gg, Gg, Gs^Fds, Gs^Fms, Gg, Gg, Gs^Fds, Gg, Gg, Gg, Gs^Fds, Gg, Gg, Rb, Gs^Fds, Gs^Fds, Gg, Gg, Gg, Ke, Ce, Ce, Gs^Fds, Gs^Fds, Ke, Rp, Ds, Ds, Ds, Ww, Ww, Wo, Wo, Wo
Gg, Gg, Gg, Re^Vct, Gg, Gs^Fds, Gg, Rrc, Rrc, Gs^Fds, Gg, Gg, Gs^Fds, Gg, Gs^Fms, Gg, Gs^Fds, Gg, Gs^Fds, Gs^Fds, Gs^Fms, Gs^Fds, Rb, Gg, Gg, Gs^Fds, Gs^Fds, Gs^Fms, Gg, Rb, Gg, Gg, Gs^Fds, Re^Vct, Gs^Fds, Gg, Gs^Fds, Re^Vct, Rp, Ds, Ds, Ww, Ww, Ww, Wo, Wo, Wo
Gg, Gg, Gg, Gg, Gg, Gg, Gg, Gg, Gg, Rrc, Re, Gg, Gg, Gg, Gg, Gg, Gg, Gs^Fds, Gs^Fms, Gg, Gg, Gs^Fds, Gs^Fds, Gg, Gs^Fds, Gg, Gs^Fds, Gs^Fds, Gg, Gg, Gs^Fms, Gs^Fds, Gs^Fds, Gs^Fds, Gg, Gs^Fds, Gg, Gg, Rrc, Ds, Ds, Ww, Ww, Ww, Wo, Wo, Wo
Gg, Gg, Gs^Fds, Gg, Gs^Fds, Gg, Gg, Gs^Fms, Gg, Gs^Fms, Gg, Re, Re, Gs^Fms, Gg, Gg, Gll^Fdw, Gg, Re, Gg, Gg, Gg, Gg, Gs^Fds, Gg, Gg, Rb, Gg, Gll^Fdw, Gs^Fds, Gs^Fds, Gs^Fds, Gg, Gs^Fms, Rb, Gg, Gg, Gg, Rrc, Ds, Ds, Ww, Ww, Wo, Wo, Wo, Wo
Gg, Gs^Fds, Gg, Gs^Fms, Gg, Gs^Fds, Gs^Fms, Gg, Gg, Gg, Gs^Fms, Gg, Gg, Rrc, Rrc, Gg, Gg, Re, Re, Rb, Gg, Gs^Fms, Gg, Gs^Fds, Gg, Gg, Rb, Gg, Gg, Gg, Gg, Gg, Rb, Rb^Dr, Rb, Gg, Rb, Rp, Ds, Ds, Ds, Ww, Ww, Wo, Wo, Wo, Wo
Gg, Gs^Fms, Gs^Fds, Gg, Gs^Fds, Gg, Gg, Rb, Rb, Gg, Gg, Gg, Rb, Gg, Gg, Rrc, Rp, Re, Gg, Gg, Gll^Fdw, Rb, Gg, Gg, Gs^Fms, Gll^Fdw, Gg, Gg, Gg, Gg, Re^Eff, Re^Eff, Re^Gvs, Re^Gvs, Re^Gvs, Rb, Re, Rp, Ds, Ds, Ww, Ww, Ww, Wo, Wo, Wo, Wo
Gg, Gs^Fds, Gg, Gg, Gs^Fms, Gg, Gg, Gg, Gs^Fms, Rb, Gs^Fms, Gg, Gg, Gg, Gg, Gd^Vhr, Re, Rp, Rp, Gg, Rb, Gg, Gg, Gg, Gg, Gs^Fds, Gll^Fdw, Gs^Fds, Gg, Rb, Rb, Rb, Rb, Rb, Rb, Re^Gvs, Gd^Vhr, Rp, Ds, Ds, Ww, Ww, Ww, Wo, Wo, Wo, Wo
Gg, Gg, Gg, Gs^Fds, Gs^Fms, Gg, Gg, Gs^Fms, Gg, Gg, Gg, Rb, Rb, Gg, Re, Re, Re^Dr, Re^Gvs, Re, Rrc, Rrc, Gg, Rb, Rb, Gg, Gg, Rb, Rb, Rb, Gg, Gg, Rb, Re^Eff, Re^Gvs, Re^Eff, Rb, Gg, Rrc, Ds, Ds, Ww, Ww, Wo, Wo, Wo, Wo, Wo
Gg, Gg, Gs^Fms, Gg, Gg, Rb, Gg, Gg, Gs^Fms, Gg, Gg, Gg, Re, Re^Gvs, Re, Re^Gvs, Rb, Re^Gvs, Re, Re^Gvs, Re, Rrc, Rrc, Gg, Gg, Rb, Rb, Rb, Rb, Gg, Gg, Gg, Gg, Re^Eff, Gg, Gg, Gg, Rrc, Ds, Ds, Ww, Ww, Wo, Wo, Wo, Wo, Wo
Gg, Gg, Gs^Fms, Gg, Rb, Gg, Rb, Gg, Gg, Gg, Re, Re^Gvs, Re, Re, Re, Re, Re, Re, Rd, Re, Re, Re, Re, Rp, Rp, Gg, Gg, Rb, Gg, Gg, Chr, Chr, Re^Dr, Gg, Gg, Gg, Gg, Rp, Ds, Ds, Ww, Ww, Wo, Wo, Wo, Wo, Wo
Gg, Gg, Gg, Gg, Gs^Fms, Gg, Gg, Gs^Dr, Re, Re^Gvs, Re^Gvs, Re, Re^Gvs, Re, Re, Re, Rb, Re, Re^Gvs, Re, Re, Rd, Re, Re, Re^Gvs, Rp, Rrc, Gg, Cer, Chr, Gg, Gg, Gg, Cer, Ch^Dr, Gg, Re, Rp, Ds, Ds, Ww, Ww, Wo, Wo, Wo, Wo, Wo
Gg, Gg, Gg, Gg, Gg, Gg, Re, Gg, Gg, Re, Re, Re, Re, Re, Re^Dr, Re^Gvs, Rb, Rb, Re^Gvs, Re^Dr, Re^Gvs, Re, Re^Gvs, Re, Gg, Gg, Cer, Rrc, Rr, Gg, Gll^Fdw, Gll^Fdw, Gg, Re, Rr^Vhc, Ch, Rr, Ds, Ds, Ds, Ww, Ww, Wo, Wo, Wo, Wo, Wo
Gg, Gs^Fms, Gg, Gg, Gs^Fms, Rb, Rb, Re, Gg, Gg, Gg, Re^Gvs, Re^Gvs, Re, Re^Gvs, Re^Gvs, Rb, Rb, Re, Re^Gvs, Re^Gvs, Re, Gg, Gg, Chr, Chr, Gg, Rp^Vhcr, Rrc, Rr, Rr, Rb, Rb, Gs^Fds, Rp, Rp, Cer, Ds, Ds, Ds, Ww, Ww, Wo, Wo, Wo, Wo, Wo
Gg, Gg, Gg, Gg, Gg, Rb, Rb, Re, Gll^Fdw, Gg, Gg, Gd^Vhr, Rp, Re, Re^Gvs, Re, Re, Re^Gvs, Re, Re, Gg, Gg, Gg, Re, Gg^Efm, Gg, Gs^Fds, Rrc, Chr, Rp, Chr, Rr, Rp, Rrc, Gs^Fds, Rp^Vhcr, Chr, Ds, Ds, Ww, Ww, Ww, Wo, Wo, Wo, Wo, Wo
Gg, Gg, Gg, Gg, Gg, Gg, Gg, Gg, Gg, Gg, Re, Rrc, Gg, Rp, Rp, Re^Gvs, Re, Re^Gvs, Rp, Gg, Rp, Rrc, Rrc, Rrc, Rp, Re, Re, Rr, Ch, Khr, Chr, Rr, Rr^Vhc, Re^Efm, Gg, Gg, Chr, Ds, Ds, Ww, Ww, Ww, Wo, Wo, Wo, Wo, Wo
Rrc, Rrc, Rrc, Re, Re, Rrc, Rp, Gg, Rp, Rrc, Gg, Gg, Re, Re, Re, Rp, Rrc, Rp, Gg, Rp, Gg, Gg, Gg, Ch, Rr^Vhc, Rp, Rrc, Rr, Rr, Rr, Rr, Rrc, Rrc, Gll^Fdw, Re, Gll^Fdw, Ch, Ds, Ww, Ww, Ww, Wo, Wo, Wo, Wo, Wo, Wo
Gg, Gg, Gg, Gg, Rb, Gg, Gg, Rp, Gg, Gg, Gg, Re, Re, Re, Re, Re, Gg, Gg, Gg, Gg, Gg, Gg, Gg, Re^Dr, Re, Re, Rp, Chr, Chr, Kh, Ch, Rp, Rrc, Gg, Ww, Re, Ch, Ds, Ww, Ww, Wo, Wo, Wo, Wo, Wo, Wo, Wo
Gg, Gg, Ds, Gg, Gg, Gg, Rb, Rb, Gg, Gg, Gg, Re, Re, Re, Re, Re, Re, Rb, Gg, Gg, Gg, Gg, Gg, Re, Gg, Re, Rp^Vhcr, Rp, Rp, Chr, Rrc, Rrc, Wo, Wo^Bw\r, Wo^Bw\r, Ww, Ww, Ww, Ww, Ww, Wo, Wo, Wo, Wo, Wo, Wo, Wo
Ds, Ds, Ds, Gg, Ds, Gg, Ds, Gg, Ds, Gg, Ds, Gg, Ds, Re, Ds, Re, Ds, Re, Ds, Gg, Ds, Gg, Ds, Chr, Ds, Ds, Ds, Rp, Rp, Rp, Wo, Wo^Bw\r, Wo^Bw\r, Wo, Wo, Wo^Bw\, Wo^Bw\r, Ww, Wo, Wo, Wo, Wo, Wo, Wo, Wo, Wo, Wo
Ds, Ds, Ds, Ds, Ds, Ds, Ds, Ds, Ds, Ds, Ds, Ds, Ds, Ds, Ds, Ds, Ds, Ds, Ds, Ds, Ds, Ds, Ds, Ch, Ds, Ds, Ds, Ds, Wo, Wo^Bw\r, Wo^Bw\r, Wo, Wo, Wo^Bw\r, Wo^Bw\, Wo, Wo, Wo, Wo, Wo, Wo, Wo, Wo, Wo, Wo, Wo, Wo
Ww, Ds, Ww, Ds, Ww, Ds, Ww, Ds, Ww, Ds, Ww, Ds, Ww, Ds, Ww, Ds, Ww, Ds, Ww, Ds, Ww, Ds, Ww, Ww, Ww, Ww, Ww, Ww, Wo, Wo, Wo, Wo^Bw\, Wo^Bw\r, Wo, Wo, Wo, Wo, Wo, Wo, Wo, Wo, Wo, Wo, Wo, Wo, Wo, Wo
Ww, Ww, Ww, Ww, Ww, Ww, Ww, Ww, Ww, Ww, Ww, Ww, Ww, Ww, Ww, Ww, Ww, Ww, Ww, Ww, Ww, Ww, Ww, Ww, Ww, Ww, Ww, Ww, Wo, Wo, Wo, Wo, Wo, Wo, Wo, Wo, Wo, Wo, Wo, Wo, Wo, Wo, Wo, Wo, Wo, Wo, Wo
Ww, Ww, Ww, Ww, Ww, Ww, Ww, Ww, Ww, Ww, Ww, Ww, Ww, Ww, Ww, Ww, Ww, Ww, Ww, Ww, Ww, Ww, Wo, Ww, Wo, Ww, Wo, Wo, Wo, Wo, Wo, Wo, Wo, Wo, Wo, Wo, Wo, Wo, Wo, Wo, Wo, Wo, Wo, Wo, Wo, Wo, Wo
Wo, Wo, Wo, Wo, Wo, Wo, Wo, Wo, Wo, Wo, Wo, Wo, Wo, Wo, Wo, Wo, Wo, Wo, Wo, Wo, Wo, Wo, Wo, Wo, Wo, Wo, Wo, Wo, Wo, Wo, Wo, Wo, Wo, Wo, Wo, Wo, Wo, Wo, Wo, Wo, Wo, Wo, Wo, Wo, Wo, Wo, Wo
Wo, Wo, Wo, Wo, Wo, Wo, Wo, Wo, Wo, Wo, Wo, Wo, Wo, Wo, Wo, Wo, Wo, Wo, Wo, Wo, Wo, Wo, Wo, Wo, Wo, Wo, Wo, Wo, Wo, Wo, Wo, Wo, Wo, Wo, Wo, Wo, Wo, Wo, Wo, Wo, Wo, Wo, Wo, Wo, Wo, Wo, Wo
Wo, Wo, Wo, Wo, Wo, Wo, Wo, Wo, Wo, Wo, Wo, Wo, Wo, Wo, Wo, Wo, Wo, Wo, Wo, Wo, Wo, Wo, Wo, Wo, Wo, Wo, Wo, Wo, Wo, Wo, Wo, Wo, Wo, Wo, Wo, Wo, Wo, Wo, Wo, Wo, Wo, Wo, Wo, Wo, Wo, Wo, Wo
Wo, Wo, Wo, Wo, Wo, Wo, Wo, Wo, Wo, Wo, Wo, Wo, Wo, Wo, Wo, Wo, Wo, Wo, Wo, Wo, Wo, Wo, Wo, Wo, Wo, Wo, Wo, Wo, Wo, Wo, Wo, Wo, Wo, Wo, Wo, Wo, Wo, Wo, Wo, Wo, Wo, Wo, Wo, Wo, Wo, Wo, Wo
