Rrc, Gg, Gs^Fms, Gg, Gg, Gg, Gg, Gg, Gg, Rrc, Gg, Gg, Gg, Gg, Gg, Gs^Fds, Gs^Fds, Gg, Gs^Fds, Gg, Gg, Gg, Gs^Fds, Gs^Fds, Gs^Fds, Gs^Fds, Gs^Fds, Gg, Gs^Fds, Gg, Gs^Fds, Gs^Fds, Gg, Gg, Gs^Fds, Gg, Gg, Gg, Re, Rrc, Ds, Ds, Ww, Ww, Wo, Wo, Wo
Gs^Fms, Rrc, Rrc, Gg, Gs^Fms, Gs^Fms, Gg, Gs^Fms, Ce, Gg, Gs^Fms, Gg, Gs^Fms, Gg, Gs^Fds, Gg, Gs^Fds, Gs^Fds, Gg, Gg, Gs^Fds, Gg, Gs^Fds, Gg, Gg, Gg, Gs^Fms, Gg, Gg, Gs^Fds, Gs^Fms, Gs^Fds, Gs^Fds, Gg, Gs^Fds, Ce, Ce, Ket, Re, Ds, Ds, Ds, Ww, Ww, Wo, Wo, Wo
Gg, Gg, Gg, Rrc, Re, Gg, Ce, Ce, Ket, Ce, Gg, Gg, Gg, Gg, Gs^Fds, Gg, Gg, Gg, Gs^Fds, Gs^Fds, Gg, Gg, Gg, Gs^Fds, Gg, Gs^Fds, Gg, Gs^Fms, Gs^Fds, Gg, Gs^Fds, Gg, Gg, Gg, Ce, Ce, Ce, Ce, Re, Ds, Ds, Ds, Ww, Ww, Wo, Wo, Wo
Gg, Gg, Gg, Gg, Ce, Re, Re, Ce, Ce, Ce, Gg, Gs^Fms, Gg, Gg, Gg, Gs^Fds, Gs^Fms, Gg, Gg, Gs^Fds, Gg, Gg, Gg, Gs^Fds, Gg, Gg, Rb, Gs^Fds, Gs^Fds, Gg, Gg, Gg, Gg, Gg, Gg, Gs^Fds, Ce, Ce, Rp, Ds, Ds, Ds, Ww, Ww, Wo, Wo, Wo
Gg, Gg, Gg, Ce, Ket, Ce, Ce, Rrc, Rrc, Gs^Fds, Gg, Gg, Gs^Fds, Gg, Gs^Fms, Gg, Gs^Fds, Gg, Gs^Fds, Gs^Fds, Gs^Fms, Gs^Fds, Rb, Gg, Gg, Gs^Fds, Gs^Fds, Gs^Fms, Gg, Rb, Gg, Gg, Gll, Gg, Gg, Gg, Gll, Gg, Rp, Ds, Ds, Ww, Ww, Ww, Wo, Wo, Wo
Gg, Gg, Gg, Ce, Ce, Ce, Gg, Gg, Gg, Rrc, Re, Gg, Gg, Gg, Gg, Gg, Gg, Gs^Fds, Gll, Gg, Gg, Gs^Fds, Gs^Fds, Gg, Gs^Fds, Gg, Gs^Fds, Gs^Fds, Gg, Gg, Gll, Gll, Gll, Gll, Gg, Gll, Gg, Gg, Rrc, Ds, Ds, Ww, Ww, Ww, Wo, Wo, Wo
Gg, Gg, Gs^Fds, Gg, Gs^Fds, Gg, Gg, Gs^Fms, Gg, Gs^Fms, Gg, Re, Re, Gll, Gg, Gg, Gll, Gg, Re, Gg, Gg, Gg, Gg, Gs^Fds, Gg, Gg, Rb, Gg, Gll, Gll, Gll, Gll, Re, Gll, Rb, Gg, Gg, Gg, Rrc, Ds, Ds, Ww, Ww, Wo, Wo, Wo, Wo
Gg, Gs^Fds, Gg, Gs^Fms, Gg, Gs^Fds, Gs^Fms, Gg, Gg, Gg, Gs^Fms, Gg, Gg, Rrc, Rrc, Gg, Gg, Re, Re, Rb, Gg, Gll, Gg, Gll, Gg, Gg, Rb, Gg, Gg, Gg, Re, Re, Rb, Re, Rb, Gg, Rb, Rp, Ds, Ds, Ds, Ww, Ww, Wo, Wo, Wo, Wo
Gg, Gs^Fms, Gs^Fds, Gg, Gs^Fds, Gg, Gg, Rb, Rb, Gg, Gg, Gg, Rb, Gg, Gg, Rrc, Rp, Re, Gg, Gg, Gg, Rb, Gg, Gg, Gll, Gll, Gg, Gg, Gg, Re, Re, Re, Gll, Gll, Gll, Rb, Re, Rp, Ds, Ds, Ww, Ww, Ww, Wo, Wo, Wo, Wo
Gg, Gs^Fds, Gg, Gg, Gs^Fms, Gg, Gg, Gg, Gs^Fms, Rb, Gs^Fms, Gg, Gg, Gg, Gg, Gg, Rd, Rp, Rp, Gg, Rb, Gg, Gg, Gg, Gg, Gll, Gll, Gll, Gg, Rb, Rb, Rb, Rd, Rd, Rd, Gll, Ce, Rp, Ce, Ds, Ww, Ww, Ww, Wo, Wo, Wo, Wo
Gg, Gg, Gg, Gs^Fds, Gs^Fms, Gg, Gg, Gs^Fms, Gg, Gg, Gg, Rb, Rb, Gg, Rd, Rd, Rd, Gll, Rd, Rrc, Rrc, Ce, Rb, Rb, Gg, Gg, Rb, Rb, Rb, Gg, Gg, Rd, Rb, Gll, Rb, Rb, Gg, Rrc, Ds, Ds, Ww, Ww, Wo, Wo, Wo, Wo, Wo
Gg, Gg, Gs^Fms, Gg, Gg, Rb, Gg, Gg, Gs^Fms, Gg, Gg, Gg, Rd, Gll, Rd, Gll, Re, Gll, Rd, Ce, Rd, Rrc, Rrc, Gg, Gg, Rb, Rb, Rb, Rb, Gg, Gg, Gg, Gg, Rb, Gg, Gg, Gg, Rrc, Ds, Ds, Ww, Ww, Wo, Wo, Wo, Wo, Wo
Gg, Gg, Gs^Fms, Gg, Rb, Gg, Rb, Gg, Gg, Gg, Rd, Gll, Rd, Rb, Rb, Rd, Rd, Rd, Rd, Rd, Rb, Rd, Rd, Rp, Rp, Gg, Gg, Rb, Gg, Gg, Ch, Ch, Ce, Gg, Gg, Gg, Gg, Rp, Ds, Ds, Ww, Ww, Wo, Wo, Wo, Wo, Wo
Gg, Gg, Gg, Gg, Gs^Fms, Gg, Gg, Gs^Dr, Rd, Gll, Gll, Rd, Gll, Rb, Rb, Rd, Re, Rd, Gll, Rb, Rb, Rb, Rd, Rd, Gll, Rp, Rrc, Gg, Ce, Ch, Gg, Gg, Gg, Ce, Ch, Gg, Re, Rp, Ds, Ds, Ww, Ww, Wo, Wo, Wo, Wo, Wo
Gg, Gg, Gg, Gg, Gg, Gg, Re, Gg, Gg, Rd, Rd, Rd, Rd, Rd, Rd, Gll, Re, Re, Gll, Rb, Gll, Rb, Gll, Rd, Gg, Gg, Ce, Rrc, Rr, Gg, Gll^Fdw, Gll^Fdw, Gg, Re, Rr^Vhc, Ch, Rr, Ds, Ds, Ds, Ww, Ww, Wo, Wo, Wo, Wo, Wo
Gg, Gs^Fms, Gg, Gg, Ce, Rb, Rb, Re, Gg, Gg, Gg, Gll, Gll, Rd, Gll, Gll, Re, Re, Rd, Gll, Gll, Rd, Gg, Gg, Ch, Ch, Gg, Rp^Vhcr, Rrc, Rr, Rr, Rb, Rb, Gs^Fds, Rp, Rp, Ce, Ds, Ds, Ds, Ww, Ww, Wo, Wo, Wo, Wo, Wo
Gg, Gg, Ce, Ket, Ce, Rb, Rb, Re, Gll, Gg, Gg, Gg, Rp, Rd, Gll, Rd, Rd, Gll, Rd, Rd, Gg, Gg, Gg, Ce, Gg^Efm, Gg, Gs^Fds, Rrc, Ch, Ce, Ch, Rr, Rp, Rrc, Gs^Fds, Rp^Vhcr, Ch, Ds, Ds, Ww, Ww, Ww, Wo, Wo, Wo, Wo, Wo
Gg, Gg, Ce, Ce, Ce, Ce, Gg, Gg, Gg, Gg, Re, Rrc, Gg, Rp, Rp, Gll, Ce, Gll, Rp, Gg, Rp, Rrc, Rrc, Rrc, Rp, Re, Re, Rr, Ch, Kh, Ch, Rr, Rr^Vhc, Re^Efm, Gg, Ket, Ch, Ds, Ds, Ww, Ww, Ww, Wo, Wo, Wo, Wo, Wo
Rrc, Rrc, Rrc, Re, Re, Rrc, Rp, Gg, Rp, Rrc, Gg, Gg, Rd, Rd, Rd, Rp, Rrc, Rp, Gg, Rp, Gg, Gg, Gg, Ch, Rr^Vhc, Rp, Rrc, Rr, Rr, Rr, Rr, Rrc, Rrc, Gll^Fdw, Re, Gll^Fdw, Ch, Ds, Ww, Ww, Ww, Wo, Wo, Wo, Wo, Wo, Wo
Gg, Gg, Gg, Gg, Rb, Gg, Gg, Rp, Gg, Gg, Gg, Rd, Rb, Rb, Rd, Rd, Ce, Gg, Gg, Gg, Gg, Gg, Gg, Ce, Re, Re, Rp, Ch, Ch, Kh, Ch, Ce, Rrc, Gg, Ww, Re, Ch, Ds, Ww, Ww, Wo, Wo, Wo, Wo, Wo, Wo, Wo
Gg, Gg, Ds, Gg, Gg, Gg, Rb, Rb, Gg, Gg, Gg, Rd, Rd, Rb, Rd, Rd, Rb, Rb, Gg, Gg, Gg, Gg, Gg, Ce, Ket, Re, Rp^Vhcr, Rp, Rp, Ch, Rrc, Rrc, Wo, Wo^Bw\r, Wo^Bw\r, Ww, Ww, Ww, Ww, Ww, Wo, Wo, Wo, Wo, Wo, Wo, Wo
Ds, Ds, Ds, Gg, Ds, Gg, Ds, Gg, Ds, Gg, Ds, Gg, Ds, Rd, Ds, Rd, Ds, Rd, Ds, Gg, Ds, Gg, Ds, Ch, Ds, Ds, Ds, Rp, Rp, Rp, Wo, Wo^Bw\r, Wo^Bw\r, Wo, Wo, Wo^Bw\, Wo^Bw\r, Ww, Wo, Wo, Wo, Wo, Wo, Wo, Wo, Wo, Wo
Ds, Ds, Ds, Ds, Ds, Ds, Ds, Ds, Ds, Ds, Ds, Ds, Ds, Ds, Ds, Ds, Ds, Ds, Ds, Ds, Ds, Ds, Ds, Ch, Ds, Ds, Ds, Ds, Wo, Wo^Bw\r, Wo^Bw\r, Wo, Wo, Wo^Bw\r, Wo^Bw\, Wo, Wo, Wo, Wo, Wo, Wo, Wo, Wo, Wo, Wo, Wo, Wo
Ww, Ds, Ww, Ds, Ww, Ds, Ww, Ds, Ww, Ds, Ww, Ds, Ww, Ds, Ww, Ds, Ww, Ds, Ww, Ds, Ww, Ds, Ww, Ww, Ww, Ww, Ww, Ww, Wo, Wo, Wo, Wo^Bw\, Wo^Bw\r, Wo, Wo, Wo, Wo, Wo, Wo, Wo, Wo, Wo, Wo, Wo, Wo, Wo, Wo
Ww, Ww, Ww, Ww, Ww, Ww, Ww, Ww, Ww, Ww, Ww, Ww, Ww, Ww, Ww, Ww, Ww, Ww, Ww, Ww, Ww, Ww, Ww, Ww, Ww, Ww, Ww, Ww, Wo, Wo, Wo, Wo, Wo, Wo, Wo, Wo, Wo, Wo, Wo, Wo, Wo, Wo, Wo, Wo, Wo, Wo, Wo
Ww, Ww, Ww, Ww, Ww, Ww, Ww, Ww, Ww, Ww, Ww, Ww, Ww, Ww, Ww, Ww, Ww, Ww, Ww, Ww, Ww, Ww, Wo, Ww, Wo, Ww, Wo, Wo, Wo, Wo, Wo, Wo, Wo, Wo, Wo, Wo, Wo, Wo, Wo, Wo, Wo, Wo, Wo, Wo, Wo, Wo, Wo
Wo, Wo, Wo, Wo, Wo, Wo, Wo, Wo, Wo, Wo, Wo, Wo, Wo, Wo, Wo, Wo, Wo, Wo, Wo, Wo, Wo, Wo, Wo, Wo, Wo, Wo, Wo, Wo, Wo, Wo, Wo, Wo, Wo, Wo, Wo, Wo, Wo, Wo, Wo, Wo, Wo, Wo, Wo, Wo, Wo, Wo, Wo
Wo, Wo, Wo, Wo, Wo, Wo, Wo, Wo, Wo, Wo, Wo, Wo, Wo, Wo, Wo, Wo, Wo, Wo, Wo, Wo, Wo, Wo, Wo, Wo, Wo, Wo, Wo, Wo, Wo, Wo, Wo, Wo, Wo, Wo, Wo, Wo, Wo, Wo, Wo, Wo, Wo, Wo, Wo, Wo, Wo, Wo, Wo
Wo, Wo, Wo, Wo, Wo, Wo, Wo, Wo, Wo, Wo, Wo, Wo, Wo, Wo, Wo, Wo, Wo, Wo, Wo, Wo, Wo, Wo, Wo, Wo, Wo, Wo, Wo, Wo, Wo, Wo, Wo, Wo, Wo, Wo, Wo, Wo, Wo, Wo, Wo, Wo, Wo, Wo, Wo, Wo, Wo, Wo, Wo
Wo, Wo, Wo, Wo, Wo, Wo, Wo, Wo, Wo, Wo, Wo, Wo, Wo, Wo, Wo, Wo, Wo, Wo, Wo, Wo, Wo, Wo, Wo, Wo, Wo, Wo, Wo, Wo, Wo, Wo, Wo, Wo, Wo, Wo, Wo, Wo, Wo, Wo, Wo, Wo, Wo, Wo, Wo, Wo, Wo, Wo, Wo
