Xoc, Xoc, Xoc, Xoc, Xoc, Xoc, Xoc, Xoc^Efs, Irs, Irs, Xoc, Xoc, Xoc, Xoc
Xoc, Xoc^Efs, Xoc, Xoc, Xoc, Xoc^Efs, Irs, Irs, Xoc, Xoc^Efs, Xoc, Xoc, Xoc, Xoc^Efs
Xoc, Xoc, Xoc, Xoc, Xoc^Efs, Irs, Irs, Xoc^Efs, Xoc, Xoc, Xoc, Xoc^Efs, Xoc, Xoc^Efs
Xoc, Xoc^Efs, Irs, Xoc, Irs^Efs, Irs, Irs, Irs, Irs, Xoc^Efs, Xoc, Xoc^Efs, Irs, Irs
Irs, Irs, Xoc, Irs, Irs, Irs, Irs, Irs, Icr, Irs, Irs, Irs, Irs, Irs
Xoc, Xoc, Xoc, Xoc, Xoc, Irs, Irs, Icr, Icr, Icr, Icr, Irs, Irs, Xoc^Efs
Xoc, Xoc, Xoc^Efs, Xoc, Xoc, Xoc^Efs, Irs, Irs, Irs, Icr, Icr, Icr, Icr, Irs
Xoc^Efs, Xoc, Xoc, Xoc^Efs, Irs, Irs, Irs, Irs, Xoc, Irs, Irs, Icr, Icr, Icr
