Md, Gg, Md, Md, Md, Md, Md, Rd, Md, Md, Md, Md, Md, Mm, Mm, Gg, Rd, Rd, Mm, Md, Md, Md, Md, Mm, Md, Mm, Md, Md, Md, Md, Md, Md, Md
Md, Md, Md, Md, Md, Md, Md, Md, Md, Md, Md, Md, Md, Md, Md, Mm, Mm, Rd, Rd, Md, Md, Md, Md, Md, Md, Md, Md, Md, Md, Md, Md, Md, Md
Md, Md, Md, Md, Md, Md, Hhd, Hhd, Hhd, Hhd, Hhd, Hhd, Hhd, Hhd, Hhd, Md, Md, Mm, Md, Rd, Md, Md, Md, Md, Md, Md, Md, Cer, Cer, Ker, Md, Md, Md
Md, Md, Md, Md, Md, Hhd, Md, Md, Md, Md, Rd, Rd, Rd, Hhd, Hhd, Hhd, Mm, Md, Md, Rb, Rb, Md, Gd^Vhr, Md, Rd, Rd, Rd, Rd, Rd, Cer, Md, Md, Md
Md, Md, Md, Hhd, Md, Md, Hhd, Hhd, Hhd, Rd, Re, Rd, Re, Rd, Rd, Hhd, Hhd, Md, Md, Md, Rd, Rd, Rd, Rd, Rd, Rd, Rd, Rd, Rd, Rd, Md, Md, Md
Md, Md, Md, Hhd, Gd, Hhd, Rd, Rd, Rd, Rd, Hhd, Re, Gd, Rd, Rd, Rd, Rd, Md, Rd, Rd, Gd, Rb, Rd, Gd, Gd, Rd, Rd, Gd, Gd, Re, Gd, Md, Md
Md, Md, Hhd, Hhd, Gd, Gd, Re, Re, Gd, Rd, Gd, Hhd, Hhd, Gd, Rd, Rd, Rd, Rd, Rd, Rd, Gd, Rb, Gd, Rd, Re, Re, Rd, Rd, Gd, Re, Re, Md, Md
Md, Md, Md, Hhd, Gd, Gd, Re, Re, Rd, Gd, Rd, Rd, Re, Rd, Rd, Rd, Rd, Rd, Rd, Rb, Gd, Re, Re, Rd, Rd, Rd, Rd, Rd, Rd, Re, Re, Md, Md
Md, Md, Hhd, Hhd, Rd, Rd, Rd, Rd, Rd, Gd, Gd, Rd, Re, Rd, Rd, Rd, Rd, Rd, Hhd, Rb, Rd, Re, Hhd, Rd, Hhd, Rd, Hhd, Hhd, Rd, Re, Gd, Md, Md
Md, Md, Gd^Vhr, Gd, Rd, Rd, Rd, Rd, Gd, Gd, Gd, Rd, Re, Re, Gd, Gd, Hhd, Hhd, Chr, Rd, Rb, Gd, Gd, Hhd, Rd, Hhd, Gd, Rd, Rd, Rd, Gd, Md, Md
Md, Md, Md, Rd, Rd, Rd, Rd, Rd, Rd, Rd, Rd, Rd, Rd, Rd, Hhd, Gd, Hhd, Chr, Khr, Hhd, Hhd, Rb, Gd, Rd, Rd, Rd, Gd, Gd, Rb, Rd, Gd, Md, Md
Md, Md, Hhd, Rd, Rd, Rd, Gd, Gd, Rd, Rd, Gd, Hhd, Md, Md, Md, Hhd, Gd^Vhr, Chr, Chr, Chr, Re^Vct, Hhd, Gd, Rb, Rb, Rb, Rb, Rb, Rd, Rd, Rb, Rd, Rd
Md, Md, Md, Hhd, Gd, Rd, Rd, Gd, Rd, Gd, Rd, Hhd, Rd, Md, Hhd, Hhd, Rd, Rd, Rd, Rd, Rd, Hhd, Hhd, Gd, Rd, Rd, Rd, Rd, Rd, Rd, Gd^Vhr, Rb, Rb
Md, Md, Hhd, Gd, Rd, Gd, Gd, Rd, Gd, Rd, Rd, Rd, Rd, Re, Re, Rd, Rd, Rd, Gd, Rd, Rd, Hhd, Hhd, Gd, Rd, Rd, Re, Rd, Hhd, Hhd, Md, Md, Md
Md, Md, Md, Hhd, Rd, Gd, Gd, Rd, Rd, Rd, Rd, Rd, Gd, Rd, Rd, Rd, Gd, Rd, Rd, Re, Rd, Rd, Hhd, Rd, Rd, Rd, Gd, Re, Gd, Hhd, Md, Md, Md
Md, Md, Md, Rd, Ce, Rd, Rd, Gd, Rd, Rd, Rd, Gd, Rd, Rd, Rd, Rd, Rd, Re, Rd, Rd, Re, Rd, Gd, Rd, Re, Re, Md, Gd, Hhd, Hhd, Md, Md, Md
Md, Md, Md, Ce, Ce, Re^Vct, Gd, Gd, Rd, Gd, Rd, Gd, Gd, Gd, Hhd, Rd, Hhd, Rd, Rd, Rd, Gd, Re, Re, Re, Gd, Md, Md, Md, Md, Hhd, Md, Md, Md
Md, Md, Md, Ke, Md, Md, Md, Gd, Md, Rd, Rd, Rd, Hhd, Hhd, Md, Hhd, Md, Hhd, Hhd, Rd, Md, Rd, Md, Rd, Md, Rd, Md, Md, Md, Md, Md, Md, Md
Md, Md, Md, Md, Md, Md, Md, Md, Md, Md, Md, Md, Md, Md, Md, Md, Md, Md, Md, Md, Md, Md, Md, Md, Md, Md, Md, Md, Md, Md, Md, Md, Md
