Md, Md, Md, Rb, Rd, Mm, Mm, Mm, Mm, Mm, Mm, Mm, Mm, Mm, Mm, Mm, Mm, Mm, Mm, Mm, Mm, Mm, Mm, Mm, Mm, Mm, Mm, Mm, Mm, Mm, Md, Md, Md, Md, Md, Md, Md, Rd, Mm, Mm
Mm, Md, Md, Rb, Rb, Mm, Mm, Mm, Rd, Mm, Rd, Mm, Mm, Mm, Gll^Fdw, Mm, Hhd, Hhd, Hhd, Mm, Hhd, Mm, Hhd, Mm, Hhd, Mm, Mm, Mm, Mm, Md, Md, Md, Md, Md, Md, Md, Md, Md, Md, Mm
Mm, Mm, Mm, Ce, Ce, Rd, Rb, Rd, Ke, Rd, Ce, Rd, Rd, Rd, Rd, Rd, Rd, Rd, Rd, Hhd, Rd, Hhd, Rd, Hhd, Hhd, Hhd, Hhd, Hhd^Vhhr, Hhd, Md, Md, Md, Md, Md, Md, Md, Md, Md, Md, Mm
Mm, Mm, Mm, Ke, Ce, Rd, Rb, Chr, Chr, Ce, Rd, Rd, Rb, Rd, Rd, Rd, Rd, Rd, Rd, Rd, Rd, Rd, Rd, Rd, Rd, Rd, Rd, Re, Re, Md, Md, Md, Md, Md, Md, Md, Md, Md, Md, Mm
Mm, Mm, Hhd, Ce, Rd, Rd, Rd, Rb, Rd, Rd, Rd, Rb, Rd, Rb, Rd, Rb, Rb, Rd, Rb, Rd, Rb, Rd, Rb, Rd, Rd, Rd, Rd, Rd, Rd, Re, Re, Md, Md, Md, Md, Md, Md, Md, Mm, Mm
Mm, Mm, Hhd, Rd, Rd, Rd, Rd, Rd, Hhd, Hhd, Hhd, Rd, Rd, Rd, Rd, Rd, Rd, Rd, Rd, Rb, Rd, Rb, Rd, Rb, Rd, Rd, Rb, Gd, Gd, Rd, Rd, Re, Re, Re, Rd, Gll^Fdw, Hhd, Hhd, Mm, Mm
Mm, Mm, Hhd, Rd, Rd, Rd, Rd, Rd, Gd^Vhr, Md, Md, Hhd, Rd, Rd, Gd, Rd, Rd, Rd, Rd, Rd, Hhd, Rd, Md, Rd, Rd, Rd, Rd, Rd, Rb, Rd, Rd, Rd, Rd, Rd, Rd, Rd, Rd, Hhd, Hhd, Mm
Mm, Mm, Hhd, Rd, Rd, Rd, Rd, Rd, Hhd, Rd, Rd, Rd, Rd, Gd, Gd, Rd, Rd, Rd, Hhd, Hhd, Md, Md, Hhd, Rd, Rd, Rd, Rb, Gd, Gd, Rb, Rd, Rd, Rd, Rb, Rb, Rb, Rd, Rb, Rb, Rb
Mm, Mm, Gll^Fdw, Rd, Rd, Rd, Hhd, Md, Md, Hhd, Hhd, Rd, Rd, Gd, Gd, Gd, Rd, Rd, Hhd, Md, Hhd, Hhd, Re, Rd, Rd, Rd, Rb, Gd, Gd, Gd, Gd, Gd, Gd, Rd, Rd, Rd, Md, Rd, Rd, Rd
Mm, Mm, Rd, Rd, Rd, Rd, Hhd, Md, Md, Md, Hhd, Rd, Gd, Rd, Rd, Rd, Rd, Gd^Vhr, Md, Md, Hhd, Re, Re, Re, Rd, Rd, Rd, Gd, Gd, Gd, Gs, Gd, Md, Rd, Md, Md, Md, Md, Md, Mm
Mm, Mm, Md, Rd, Md, Rd, Rd, Hhd, Hhd, Md, Rd, Rd, Gd, Rd, Hhd, Hhd, Hhd, Rd, Rd, Hhd, Re, Re, Rd, Rd, Rd, Rd, Rb, Gd, Gs, Gd^Fetd, Wwg, Md, Md, Md, Md, Md, Mm, Mm, Mm, Mm
Md, Md, Md, Hhd, Hhd, Md, Md, Rd, Re, Re, Re, Rd, Rd, Rd, Hhd, Md, Md, Rd, Gd, Rd, Hhd, Hhd, Hhd, Rd, Hhd, Rd, Rd, Rb, Rb, Wwg, Wwg, Md, Md, Md, Md, Md, Md, Mm, Mm, Mm
Md, Md, Md, Hhd, Hhd, Md, Md, Md, Md, Re, Re, Re, Re, Rd, Rd, Hhd, Rd, Rd, Gd, Rd, Hhd, Md, Hhd, Hhd, Md, Md, Re^Vct, Rd, Rd, Rb, Rb, Rd, Rd, Md, Md, Md, Md, Md, Mm, Mm
Md, Md, Md, Hhd, Hhd, Md, Md, Md, Md, Md, Hhd, Re, Re, Re, Re, Rd, Md, Rd, Rd, Rd, Hhd, Md, Md, Md, Md, Gll^Fdw, Chr, Chr, Rd, Rb, Rd, Chr, Rd^Dr, Rd, Md, Md, Md, Md, Mm, Mm
Mm, Md, Hhd, Hhd, Cte, Md, Md, Md, Md, Md, Md, Hhd, Hhd, Re, Re, Hhd, Hhd, Md, Hhd, Rd, Rd, Hhd, Md, Md, Hhd, Rd, Ch, Rd, Gs, Gg^Ve, Rd, Rp^Vhcr, Rd^Dr, Rd, Md, Md, Md, Md, Mm, Mm
Md, Md, Hhd, Cte, Cte, Cte, Cte, Md, Hhd, Md, Md, Md, Hhd^Vhhr, Re, Rd, Rd, Hhd, Md, Md, Rd, Hhd, Hhd, Md, Md, Hhd, Rd, Rd^Dr, Re, Rr^Vhc, Gs, Rd, Rd, Chr, Rd, Md, Md, Md, Md, Md, Mm
Md, Md, Md, Md, Md, Kte, Re^Vct, Hhd, Md, Hhd, Hhd, Hhd, Md, Hhd, Md, Rd, Rd, Hhd, Rd, Rd, Hhd, Md, Md, Md^Xm, Md, Rd, Rd, Ch, Chr, Kh, Ch, Ch, Rd, Gll^Fdw, Md, Md, Md, Md, Mm, Mm
Md, Md, Md, Md, Md, Md, Md, Md, Md, Md, Md, Md, Md, Md, Md, Hhd, Gll^Fdw, Rd, Hhd, Hhd, Md, Md, Md, Md^Xm, Md^Xm, Md, Md, Rd, Rd, Rd, Rd, Rd, Md, Md, Md, Md, Md, Md, Mm, Mm
Md, Md, Md, Md, Md, Md, Md, Md, Md, Md, Md, Md, Md, Md, Md, Md, Hhd, Hhd, Md, Md, Md, Md, Md^Xm, Md^Xm, Md^Xm, Md^Xm, Md^Xm, Md, Md, Md, Md, Md, Md, Md, Md, Md, Mm, Md, Mm, Mm
Md, Md, Md, Md, Md, Md, Md, Md, Md, Md, Md, Md, Md, Md, Md, Md, Md, Mm, Mm, Md, Md^Xm, Md^Xm, Md^Xm, Md^Xm, Md^Xm, Md^Xm, Md^Xm, Md^Xm, Md, Md, Md, Md, Md, Md, Mm, Mm, Mm, Mm, Mm, Mm
Mm, Md, Mm, Md, Md, Md, Md, Md, Md, Md, Md, Md, Md, Md, Md, Md, Md^Xm, Md^Xm, Md^Xm, Md^Xm, Md^Xm, Md^Xm, Mm, Md^Xm, Mm, Md^Xm, Md^Xm, Md^Xm, Md^Xm, Md^Xm, Mm, Md, Md, Md, Md, Mm, Mm, Mm, Mm, Mm
