Xoc, Xoc, Xoc, Xoc, Xoc, Xoc, Xoc, Xoc, Xoc, Xoc, Xoc, Xoc, Xoc, Xoc, Xoc, Xoc, Xoc, Xoc, Xoc, Xoc, Xoc, Xoc, Xoc, Xoc, Xoc, Xoc, Xoc, Xoc, Xoc, Xoc, Xoc
Xoc, Xoc, Xoc, Xoc, Xoc, Xoc, Xoc, Xoc, Xoc, Xoc, Xoc, Xoc, Xoc, Xoc, Xoc, Xoc, Xoc, Xoc, Xoc, Xoc, Xoc, Xoc, Xoc, Xoc, Xoc, Xoc, Xoc, Xoc, Xoc, Xoc, Xoc
Xoc, Xoc, Xoc, Xoc, Xoc, Xoc, Xoc, Xoc, Xoc, Xoc, Xoc, Xoc, Xoc, Xoc, Xoc, Xoc, Xoc, Xoc, Xoc, Xoc, Xoc, Xoc, Xoc, Xoc, Xoc, Xoc, Xoc, Xoc, Xoc, Xoc, Xoc
Xoc, Xoc, Xoc, Xoc, Xoc, Xoc, Xoc, Xoc, Xoc, Xoc, Xoc, Xoc, Xoc, Xoc, Xoc, Xoc, Xoc, Xoc, Xoc, Xoc, Xoc, Xoc, Xoc, Xoc, Xoc, Xoc, Xoc, Xoc, Xoc, Xoc, Xoc
Xoc, Xoc, Xoc, Xoc, Xoc, Xoc, Xoc, Xoc, Xoc, Xoc, Ias, Xoc, Xoc, Xoc, Xoc, Xoc, Xoc, Xoc, Xoc, Xoc, Xoc, Xoc, Ias, Ias, Ias, Xoc, Xoc, Xoc, Xoc, Xoc, Xoc
Xoc, Xoc, Xoc, Xoc, Xoc, Xoc, Xoc, Xoc, Ias, Ias, Ias, Ias, Ias, Xoc, Xoc, Xoc, Xoc, Xoc, Xoc, Xoc, Ias, Ias, Ias, Ias, Ias, Ias, Ias, Xoc, Xoc, Xoc, Xoc
Xoc, Xoc, Xoc, Xoc, Xoc, Xoc, Ias, Ias, Ias, Ias, Ias, Ias, Xoc, Xoc, Xoc, Xoc, Xoc, Xoc, Xoc, Ias, Ias, Ias, Ias, Ias, Ias, Ias, Ias, Ias, Ias, Xoc, Xoc
Xoc, Xoc, Xoc, Xoc, Ias, Ias, Ias, Ias, Ias, Ias, Ias, Xoc, Xoc, Xoc, Xoc, Xoc, Xoc, Xoc, Xoc, Xoc, Ias, Ias, Ias, Ias, Ias, Ias, Ias, Ias, Xoc, Xoc, Xoc^_fme
Xoc, Xoc, Xoc, Ias, Ias, Ias, Ias, Ias, Xoc, Ias, Ias, Ias, Ias, Xoc, Xoc, Xoc, Xoc, Xoc, Ias, Ias, Ias, Ias, Xoc, Ias, Ias, Ias, Xoc, Xoc, Xoc^_fme, Xoc^_fme, Xoc^_fme
Xoc, Xoc, Xoc, Xoc, Xoc, Ias, Xoc, Xoc, Xoc, Xoc, Xoc, Ias, Ias, Ias, Ias, Xoc, Ias, Ias, Ias, Ias, Xoc, Xoc, Xoc, Xoc, Xoc, Xoc, Xoc^_fme, Xoc^_fme, Xoc^_fme, Xoc^_fme, Xoc^_fme
Xoc, Xoc, Xoc, Xoc, Xoc, Xoc, Xoc, Xoc, Xoc, Xoc, Xoc, Xoc, Xoc, Ias, Ias, Ias, Ias, Ias, Xoc, Xoc, Xoc, Xoc, Xoc, Xoc, Xoc^_fme, Xoc^_fme, Xoc^_fme, Xoc^_fme, Xoc^_fme, Xoc^_fme, Xoc^_fme
Xoc, Xoc, Xoc, Xoc, Xoc, Xoc, Xoc, Xoc, Xoc, Xoc, Xoc, Xoc, Ias, Ias, Ias, Ias, Ias, Ias, Ias, Xoc, Xoc, Xoc, Xoc^_fme, Xoc^_fme, Xoc^_fme, Xoc^_fme, Xoc^_fme, Xoc^_fme, Xoc^_fme, Xoc^_fme, Xoc^_fme
Xoc, Xoc, Xoc, Xoc, Xoc, Xoc, Xoc, Xoc, Xoc, Xoc, Ias, Ias, Ias, Ias, Xoc, Xoc, Xoc, Ias, Ias^Dr, Ias^Dr, Ias^_fme, Xoc^_fme, Xoc^_fme, Xoc^_fme, Xoc^_fme, Xoc^_fme, Xoc^_fme, Xoc^_fme, Xoc^_fme, Xoc^_fme, Xoc^_fme
Xoc, Xoc, Xoc, Xoc, Xoc, Xoc, Xoc, Xoc, Ias, Ias, Ias, Ias, Xoc, Xoc, Xoc, Xoc, Xoc, Xoc, Xoc^_fme, Ias^_fme, Ias^_fme, Ias^_fme, Ias^_fme, Xoc^_fme, Xoc^_fme, Xoc^_fme, Xoc^_fme, Xoc^_fme, Xoc^_fme, Xoc^_fme, Xoc^_fme
Xoc, Xoc, Xoc, Xoc, Xoc, Xoc, Ias, Ias, Ias, Ias, Xoc, Xoc, Xoc, Xoc, Xoc, Xoc, Xoc^_fme, Xoc, Xoc^_fme, Xoc^_fme, Xoc^_fme, Ias^_fme, Ias^_fme, Ias^_fme, Ias^_fme, Xoc^_fme, Xoc^_fme, Xoc^_fme, Xoc^_fme, Xoc^_fme, Xoc
