Md, Md, Md, Md, Md, Md, Md, Md, Rd, Rb, Rb, Rd, Rd, Rd, Rd, Rd, Rd, Rd, Rd, Rd, Rd, Rd, Rd, Rd, Rd, Rd, Rd, Rd, Rd, Rd, Rd, Rd, Rd, Rd, Rd, Rd, Rd, Rd, Rd, Rd, Rd, Rd, Rd, Rd, Rd, Rd, Rb, Rb, Rd, Rd, Md, Md, Md, Md
Md, Md, Md, Md, Hhd, Rd, Rd, Rd, Rd, Rd, Rd, Rd, Rb, Rd, Rd, Rd, Rd, Rd, Md, Rd, Rd, Rd, Rd, Rd, Rd, Rd, Md, Rd, Rd, Rd, Hhd, Rd, Rd, Rd, Hhd, Hhd, Hhd, Rd, Rd, Rd, Rd, Rd, Rb, Rb, Rd, Rd, Rd, Rd, Rd, Rd, Rd, Md, Md, Md
Md, Md, Rd, Hhd, Rd, Rd, Rd, Rd, Rd, Rd, Rd, Rd, Rd, Rb, Rd, Rd, Rd, Rd, Gll^Fdw, Md, Rd, Rd, Rd, Rd, Rd, Md, Md, Rd, Rd, Hhd, Hhd, Rd, Rd, Rd, Rd, Hhd, Md, Md, Rd, Rd, Rd, Rd, Rd, Rd, Rd, Rd, Ce, Rd, Rd, Rd, Rd, Md, Md, Rd
Md, Rd, Rd, Rd, Rd, Rd, Rd, Rd, Rd, Rd, Rd, Rd, Rd, Rd, Rd, Rd, Rb, Rd, Rd, Md, Rd, Rd, Hhd, Hhd, Rd, Md, Rd, Rd, Rd, Hhd, Rd, Rd, Rd, Rd, Rd, Rd, Rd, Rd, Rd, Rd, Rd, Rd, Rd, Rd, Rd, Ce, Ket, Ce, Rd, Rd, Rd, Md, Md, Rd
Md, Rd, Rd, Rd, Ce, Re^Vct, Ce, Rd, Rd, Rd, Rd, Rd, Rd, Rd, Rd, Rd, Rb, Rd, Rd, Rd, Rd, Rd, Hhd, Hhd, Rd, Rd, Rd, Rd, Rd, Rd, Rd, Rd, Rd, Hhd, Hhd, Rd, Rd, Rd, Rd, Rd, Rd, Rb, Rd, Rd, Rd, Rd, Re^Vct, Ce, Rd, Rd, Md, Md, Md, Rd
Rd, Rd, Rd, Rd, Rd, Ce, Ket, Ce, Rd, Rd, Rd, Rd, Rd, Rd, Rd, Rd, Rd, Rd, Rb, Rd, Rd, Rd, Rd, Rd, Rd, Rd, Rd, Rd, Rd, Rd, Md, Md, Hhd, Hhd, Hhd, Rd, Rd, Rd, Rd, Rd, Rb, Rd, Rd, Rd, Rd, Rd, Rd, Rd, Rd, Rd, Rd, Rd, Rd, Rd
Rd, Rd, Rd, Rd, Rd, Rd, Rd, Rd, Rd, Rd, Rd, Rd, Rd, Rd, Rd, Rd, Rd, Rd, Rd, Rb, Rd, Rd, Rd, Rd, Rd, Rd, Rd, Rd, Rd, Rd, Rd, Rd, Rd, Rd, Rd, Rd, Rd, Rd, Rd, Rb, Rd, Rd, Rd, Rd, Rd, Rd, Rd, Rd, Rd, Rd, Rd, Rd, Rd, Rd
Rd, Rd, Md, Rd, Rd, Rd, Rd, Rd, Md, Rd, Rd, Rd, Rd, Rd, Rd, Rd, Rd, Rd, Rd, Rd, Rd, Rd, Rb, Rd, Rd, Rd, Rd, Rd, Hhd, Hhd, Rd, Rd, Rd, Rd, Rd, Rd, Rb, Rb, Rd, Rd, Rd, Rd, Rd, Rd, Rd, Rd, Rd, Rd, Hhd, Hhd, Rd, Rd, Rd, Rd
Rd, Rd, Md, Gll^Fdw, Rd, Rd, Rd, Rd, Gll^Fdw, Md, Rd, Hhd, Hhd, Hhd, Rd, Rd, Rd, Rd, Rd, Rd, Rd, Rd, Rd, Rb, Rd, Rd, Rd, Hhd, Rd, Rd, Ce, Ce, Ce, Rd, Rb, Rd, Rd, Rd, Rd, Rd, Rd, Rd, Rd, Md, Md, Md, Rd, Rd, Hhd, Hhd, Rd, Rd, Rd, Rd
Rd, Rd, Rd, Rd, Rd, Rd, Rd, Rd, Rd, Rd, Rd, Rd, Rd, Hhd, Rd, Rd, Rd, Rd, Rd, Rd, Rd, Rd, Rd, Rd, Rd, Re, Rb, Rd, Ce, Ce, Gll^Fdw, Gs^Vc, Rb, Re, Ce, Rd, Rd, Hhd, Hhd, Hhd, Hhd, Rd, Rd, Md, Md, Gll^Fdw, Rd, Rd, Rd, Rd, Rd, Rd, Rd, Rd
Rd, Rd, Hhd, Hhd, Hhd, Rd, Rd, Rd, Rd, Rd, Rd, Rd, Rd, Rd, Rd, Rd, Rd, Rd, Md, Rd, Rd, Hhd, Rd, Rd, Rd, Rd, Ce, Rd, Rb, Rp^Vhcr, Gd, Rb, Gs, Re, Rp^Vhcr, Ce, Ce, Rd, Rd, Hhd, Rd, Hhd, Hhd, Rd, Rd, Rd, Hhd, Rd, Rd, Rd, Md, Rd, Rd, Rd
Rd, Rd, Rd, Hhd, Gll^Fdw, Rd, Rd, Rd, Hhd, Hhd, Rd, Rd, Rd, Rd, Rd, Rd, Md, Md, Gll^Fdw, Rd, Rd, Hhd, Rd, Rd, Rd, Ce, Gs^Vht, Rb, Gd, Rb, Rd, Rb, Rr^Vhc, Wwg, Rd, Rb, Rd, Rd, Rd, Rd, Rd, Rd, Rd, Rd, Rd, Hhd, Hhd, Rd, Rd, Rd, Gll^Fdw, Md, Rd, Rd
Rd, Rd, Rd, Rd, Rd, Rd, Rd, Rd, Hhd, Hhd, Rd, Rd, Rd, Rd, Rd, Rd, Rd, Md, Rd, Rd, Rd, Hhd, Rd, Hhd, Rd, Ce, Ce, Gd, Re, Hh^Vhh, Rb, Re, Rb, Rb, Rd, Gs^Vh, Ce, Rb, Rb, Rd, Rd, Rd, Rd, Rd, Rd, Hhd, Rd, Rd, Rd, Rd, Hhd, Md, Rd, Rd
Rd, Rd, Rd, Rd, Md, Rd, Rd, Rd, Rd, Rd, Rd, Rd, Rd, Rd, Hhd, Rd, Rd, Rd, Rd, Rd, Rd, Rd, Rd, Hhd, Hhd, Rd, Rd, Ce, Rd, Rb, Gd, Gd, Re, Re, Ce, Ce, Rd, Rd, Hhd, Rd, Rd, Rd, Rd, Rd, Rd, Rd, Rd, Rd, Rd, Hhd, Rd, Rd, Md, Md
Rd, Rd, Rd, Md, Rd, Rd, Rd, Rd, Rd, Rd, Rd, Rd, Rd, Hhd, Hhd, Hhd, Rd, Rd, Rd, Rd, Rd, Rd, Rd, Rd, Rd, Rd, Rd, Rb, Ce, Gd^Vhr, Ce, Ce, Rb, Hhd^Vhhr, Ce, Rd, Rd, Hhd, Hhd, Rd, Rd, Rb, Rb, Rd, Rd, Rd, Rd, Rd, Rd, Rd, Md, Md, Hhd, Rd
Rd, Rd, Rd, Rd, Rd, Rd, Rd, Rd, Rd, Rd, Rd, Rd, Rd, Rd, Rd, Hhd, Rd, Rd, Rd, Rd, Rd, Rd, Rd, Rd, Rb, Rb, Rd, Rd, Rd, Ce, Rd, Rd, Rd, Ce, Rd, Rd, Rd, Hhd, Hhd, Rd, Rd, Rd, Rd, Rd, Rd, Rd, Rd, Rd, Rd, Rd, Md, Md, Hhd, Rd
Rd, Rd, Rd, Rd, Rd, Rd, Rd, Rd, Md, Rd, Rd, Rd, Rd, Rd, Rd, Rd, Rd, Rd, Rd, Rd, Rd, Rd, Rb, Rd, Rd, Rd, Rd, Hhd, Hhd, Rd, Rd, Rd, Rb, Rd, Rd, Rd, Md, Md, Hhd, Rd, Rd, Rd, Rd, Rd, Rd, Rb, Rb, Rd, Rd, Rd, Rd, Rd, Hhd, Rd
Md, Gll^Fdw, Rd, Rd, Rd, Rd, Rd, Rd, Rd, Md, Rd, Rd, Rd, Rd, Rd, Rd, Rd, Rd, Rb, Rd, Rd, Rb, Rd, Rd, Rd, Rd, Rd, Rd, Rd, Hhd, Rd, Rd, Rd, Rd, Rd, Rd, Rd, Gll^Fdw, Rd, Rd, Rd, Rd, Rd, Rd, Rd, Rd, Rd, Rd, Rd, Rd, Rd, Hhd, Rd, Rd
Md, Md, Hhd, Rd, Rd, Rd, Rd, Rd, Rd, Rd, Rd, Rd, Rd, Rd, Rd, Rd, Rd, Rb, Rd, Rb, Rd, Rd, Rd, Rd, Rd, Rd, Rd, Rd, Rd, Rd, Rd, Rd, Rb, Rd, Rd, Rd, Rd, Rd, Rd, Rd, Rd, Rd, Md, Rd, Rd, Rd, Rd, Rb, Rb, Rd, Rd, Rd, Rd, Rd
Md, Md, Cfr, Hhd, Md, Rd, Rd, Rd, Rd, Rd, Rd, Rd, Rd, Rd, Rb, Rb, Rd, Rd, Rd, Rd, Rd, Rd, Rd, Rd, Rd, Rd, Rd, Rd, Rd, Rd, Rd, Rd, Rb, Rd, Rd, Rd, Rd, Rd, Rd, Rd, Md, Md, Md, Md, Rd, Rd, Rd, Rd, Rd, Rd, Rd, Rd, Md, Md
Md, Cfr, Kfr, Cfr, Md, Md, Rd, Rd, Rd, Rd, Rd, Rd, Rb, Rd, Rd, Rd, Rd, Rd, Rd, Rd, Md, Rd, Rd, Hhd, Hhd, Hhd, Rd, Rd, Rd, Rd, Rd, Rd, Rd, Rd, Rd, Rd, Rd, Rd, Rd, Rd, Rd, Gll^Fdw, Rd, Hhd, Hhd, Rd, Rd, Rd, Rd, Rb, Rb, Rd, Md, Rd
Md, Cfr, Md, Md, Hhd^Vhhr, Hhd, Rd, Rd, Rd, Rd, Rb, Rd, Rd, Rd, Rd, Rd, Rd, Rd, Md, Gll^Fdw, Rd, Rd, Rd, Rd, Hhd, Hhd, Rd, Rd, Rd, Rd, Rd, Rd, Rb, Rd, Rd, Rd, Rd, Rd, Hhd, Rd, Rd, Rd, Rd, Hhd, Hhd, Rd, Rd, Rd, Rd, Rd, Rd, Rd, Rd, Rd
Md, Md, Md, Md, Hhd, Hhd, Rd, Rd, Rd, Rb, Rd, Rd, Rd, Rd, Rd, Rd, Rd, Rd, Rd, Rd, Rd, Hhd, Hhd, Rd, Rd, Rd, Rd, Rd, Rd, Rd, Rd, Rd, Rb, Gd^Vhr, Rd, Rd, Rd, Hhd, Hhd, Rd, Rd, Rd, Rd, Hhd, Rd, Rd, Rd, Rd, Rd, Rd, Md, Rb, Rb, Rd
Md, Md, Hhd, Hhd, Rd, Rd, Rd, Rb, Rd, Rd, Rd, Rd, Rd, Rd, Rd, Rd, Rd, Rd, Rd, Rd, Rd, Hhd, Rd, Rd, Md, Rd, Rd, Rd, Rd, Rd, Rd, Rd, Rd, Rd, Rd, Rd, Rd, Hhd, Hhd, Rd, Rd, Rd, Rd, Rd, Rd, Rd, Hhd, Rd, Rd, Md, Md, Md, Rd, Rd
Md, Md, Md, Rd, Rb, Rb, Rd, Rd, Ce, Rd, Rd, Rd, Rd, Rd, Rd, Rd, Rd, Rd, Rd, Rd, Rd, Rd, Rd, Md, Gll^Fdw, Md, Md, Rd, Rd, Rd, Rd, Rd, Rb, Rd, Rd, Rd, Rd, Rd, Rd, Rd, Rd, Rd, Rd, Rd, Rd, Hhd, Hhd, Gll^Fdw, Rd, Rd, Rd, Rd, Rb, Rd
Md, Md, Rd, Rb, Rd, Rd, Hhd, Ce, Ke, Re^Vct, Rd, Rd, Rd, Rd, Rd, Rd, Md, Rd, Rd, Rd, Hhd, Hhd, Hhd, Rd, Rd, Gll^Fdw, Rd, Rd, Rd, Rd, Rd, Rd, Rb, Rd, Rd, Rd, Rd, Rd, Rd, Rd, Hhd, Hhd, Rd, Rd, Md, Rd, Rd, Rd, Rd, Rd, Rd, Rd, Rd, Rb
Hhd, Hhd, Rd, Rd, Rd, Hhd, Md, Md, Ce, Ce, Rd, Rd, Rd, Rd, Rd, Md, Rd, Rd, Rd, Rd, Hhd, Hhd, Rd, Rd, Rd, Rd, Rd, Rd, Rd, Rd, Rd, Rd, Rd, Rd, Md, Md, Rd, Rd, Rd, Rd, Rd, Hhd, Rd, Gll^Fdw, Md, Rd, Rd, Rd, Rd, Rd, Rd, Rd, Md, Rd
Rd, Rd, Rb, Rb, Md, Md, Md, Hhd, Rd, Rd, Rd, Rd, Rd, Rd, Rd, Md, Rd, Rd, Rd, Rd, Rd, Hhd, Rd, Rd, Rd, Rd, Rd, Rd, Rd, Md, Md, Rd, Rb, Rd, Md, Md, Rd, Rd, Rd, Rd, Rd, Rd, Rd, Rd, Rd, Rd, Rd, Rd, Rd, Rd, Md, Md, Md, Md
Rd, Rb, Md, Md, Md^Xm, Md^Xm, Md^Xm, Rd, Rd, Rd, Rd, Rd, Rd, Rd, Rd, Rd, Rd, Rd, Rd, Rd, Rd, Rd, Rd, Rd, Rd, Rd, Rd, Rd, Rd, Md, Md, Rd, Rb, Md, Md, Md, Md, Rd, Rd, Rd, Rd, Rd, Rd, Rd, Rd, Rd, Rd, Rd, Md, Md, Rd, Md, Md, Md
