Xos, Xos, Xos, Xos, Xos, Xos, Xos, Xos, Xos, Xos
Xos, Xos, Xos, Xos, Icn, Icn, Icn, Xos, Xos, Xos
Xos, Xos, Iwr, Iwr, Iwr, Icn, Iwr, Iwr, Iwr, Xos
Iwr, Iwr, Iwr, Iwr, Iwr, Iwr, Iwr, Iwr, Xos, Xos
Xos, Xos, Xos, Iwr, Iwr^Ebn, Iwr, Xos, Xos, Xos, Xos
Xos, Xos, Xos, Xos, Xos, Xos, Xos, Xos, Xos, Xos
