Mm^Xm, Mm^Xm, Mm^Xm, Mm^Xm, Mm^Xm, Mm^Xm, Mm^Xm, Mm^Xm, Mm^Xm, Mm^Xm, Mm^Xm, Mm^Xm, Mm^Xm, Mm^Xm, Mm^Xm, Mm^Xm, Mm^Xm, Mm^Xm, Mm^Xm, Mm^Xm, Mm^Xm, Mm^Xm, Mm^Xm, Mm^Xm, Mm^Xm, Mm^Xm, Mm^Xm, Mm^Xm, Mm^Xm, Mm^Xm, Mm^Xm, Mm^Xm, Ww, Mm^Xm, Mm^Xm, Mm^Xm, Mm^Xm, Mm^Xm
Mm^Xm, Mm^Xm, Mm^Xm, Mm^Xm, Mm^Xm, Mm^Xm, Mm^Xm, Mm^Xm, Mm^Xm, Mm^Xm, Mm, Mm^Xm, Mm, Mm^Xm, Mm, Mm^Xm, Mm, Mm^Xm, Mm, Mm^Xm, Mm, Mm^Xm, Mm, Mm^Xm, Mm, Mm^Xm, Mm, Mm^Xm, Mm, Mm^Xm, Mm, Ww, Ww, Mm^Xm, Mm^Xm, Mm^Xm, Mm^Xm, Mm^Xm
Mm^Xm, Mm^Xm, Mm^Xm, Mm^Xm, Mm^Xm, Mm^Xm, Mm, Mm, Mm, Mm, Mm, Mm, Mm, Mm, Mm, Mm, Mm, Mm, Mm, Mm, Mm, Mm, Mm, Mm, Mm, Mm, Mm, Mm, Mm, Mm, Mm, Ww, Ww, Mm, Mm, Mm, Mm, Mm^Xm
Mm^Xm, Mm^Xm, Mm^Xm, Mm^Xm, Mm, Mm, Mm, Mm, Mm, Mm, Mm, Mm, Mm, Mm, Mm, Mm, Mm, Mm, Mm, Mm, Hh, Mm, Hh, Mm, Hh, Hh, Hh, Mm, Hh, Mm, Hh, Ww, Ww, Mm, Mm, Mm, Mm, Mm^Xm
Mm^Xm, Mm^Xm, Mm, Mm, Mm, Mm, Mm, Mm, Hh, Hh, Gll^Fmf, Gll^Fmf, Gll^Fmf, Gll^Fmf, Gll^Fmf, Hh, Hh, Hh, Hh, Hh, Re, Hh^Vhh, Gg, Hh, Gg, Hh, Gg, Hh, Ds, Hh, Ww, Ww, Ww, Hh, Hh, Hh, Mm^Xm, Mm^Xm
Mm^Xm, Mm, Mm, Mm, Mm, Mm, Hh, Hh, Gll^Fmf, Gll^Fmf, Cvr, Kvr, Cvr, Gll^Fmf, Gll^Fmf, Gll^Fmf, Gg, Gg, Re, Re, Gg^Efm, Gg, Gll^Fmf, Gg, Gll^Fmf, Gg, Gg, Ds, Ww, Ww, Ww, Ww, Gg, Gg, Gg, Gg, Mm, Mm^Xm
Mm^Xm, Mm, Mm, Mm, Hh, Hh, Gg, Gll^Fmf, Gll^Fmf, Cvr, Re, Gg^Fet, Re, Cvr, Gll^Fmf, Gll^Fmf, Re, Re, Re, Gg^Efm, Gg^Efm, Gll^Fmf, Gll^Fmf, Gll^Fmf, Gll^Fmf, Gll^Fmf, Ww, Ww, Ww, Ww, Ds, Gg, Gg, Gg^Efm, Gg^Efm, Gg^Efm, Mm, Mm^Xm
Mm^Xm, Mm, Mm, Mm, Gg, Gg, Gg, Gll^Fmf, Gll^Fmf, Cvr, Gll^Fmf, Re, Re, Gll^Fmf, Re, Re, Gll^Fmf, Gll^Fmf, Gll^Fmf, Re, Re, Gg, Gg, Gg, Ww, Ww, Ww, Ww, Gll^Fmf, Ds, Gg, Gg, Gll^Fmf, Gg, Mm, Mm, Mm, Mm^Xm
Mm^Xm, Mm, Mm, Mm, Hh, Gg, Gg, Gll^Fmf, Gll^Fmf, Gll^Fmf, Gll^Fmf, Gll^Fmf, Gll^Fmf, Re, Gg, Gll^Fmf, Gll^Fmf, Gll^Fmf, Gll^Fmf, Gll^Fmf, Gll^Fmf, Re, Ww^Bw\, Ww, Ww, Ww, Gll^Fmf, Gll^Fmf, Gll^Fmf, Gg, Gll^Fmf, Gll^Fmf, Gll^Fmf, Gll^Fmf, Mm, Mm, Mm^Xm, Mm^Xm
Mm^Xm, Mm, Mm, Mm, Hh, Gg, Gll^Fmf, Gg, Gg, Gll^Fmf, Gg, Gg, Gg, Gg, Gg, Gg^Efm, Gg^Efm, Gll^Fmf, Gg, Gg, Ww, Ww, Ww, Ww^Bw\, Re, Gll^Fmf, Gg, Gll^Fmf, Gll^Fmf, Gg, Gg, Gg, Gg, Gg, Mm, Mm^Xm, Mm^Xm, Mm^Xm
Mm^Xm, Mm, Mm, Hh, Gll^Fmf, Gg, Gll^Fmf, Gg, Gll^Fmf, Gg, Gg, Gg, Ww, Ww, Ww, Gg^Efm, Gg^Efm, Gg, Ww, Ww, Ww, Ww, Re, Re, Gg, Re, Re, Gg, Ce, Gg, Ce, Ce, Ce, Gg, Mm, Mm^Xm, Mm^Xm, Mm^Xm
Mm^Xm, Mm, Mm, Hh, Gg, Gll^Fmf, Gll^Fmf, Gll^Fmf, Gll^Fmf, Gll^Fmf, Ww, Ww, Ww, Ww, Ww, Ww, Ww, Wwr, Wwr, Ww, Re, Re, Gll^Fmf, Gll^Fmf, Gg, Gg, Ce, Re, Re, Gg, Ce, Ket, Ce, Gg, Mm, Mm^Xm, Mm^Xm, Mm^Xm
Mm^Xm, Mm, Mm, Hh, Gg, Gg, Gg, Gg, Ww, Ww, Ww, Ww, Gll^Fmf, Gll^Fmf, Gll^Fmf, Ww, Ww, Ww, Re, Re, Gg^Efm, Gll^Fmf, Gll^Fmf, Gll^Fmf, Gll^Fmf, Gll^Fmf, Gll^Fmf, Gg, Gs^Vh, Re, Re, Re, Gs^Vh, Gg^Efm, Mm, Mm^Xm, Mm^Xm, Mm^Xm
Mm^Xm, Mm, Gll^Fmf, Gg, Gll^Fmf, Gg, Gll^Fmf, Gg, Ww, Ww, Gg, Gll^Fmf, Gll^Fmf, Gg^Fet, Gll^Fmf, Gg, Gll^Fmf, Re, Gg, Gg, Gg^Efm, Gg^Efm, Gg, Gg, Gg, Gg, Ce, Gg, Gg, Re, Gg^Ve, Re, Gg^Efm, Gg^Efm, Mm, Mm, Mm^Xm, Mm^Xm
Mm^Xm, Mm, Gll^Fmf, Gll^Fmf, Gg^Fet, Gll^Fmf, Gll^Fmf, Gg, Ww, Ww, Gg, Gll^Fmf, Gg^Fet, Gg, Gg^Fet, Gll^Fmf, Gg, Re, Gg, Gg, Re, Gg, Re, Gg, Re, Re, Re, Gg, Re, Re, Re, Re, Gs^Vh, Gg, Gg^Efm, Mm, Mm, Mm^Xm
Mm^Xm, Mm, Gll^Fmf, Gll^Fmf, Gll^Fmf, Gll^Fmf, Gg, Gg, Ww, Ww, Ww, Gll^Fmf, Gll^Fmf, Gll^Fmf, Gll^Fmf, Gll^Fmf, Gll^Fmf, Re, Re, Re, Gg, Re, Gg, Re, Gg, Gg, Ce, Re, Gg, Gs^Vh, Ds, Ds, Ww, Wwr, Wwr, Mm, Mm, Mm^Xm
Mm^Xm, Mm, Gg, Gll^Fmf, Gs, Gll^Fmf, Gs, Gs, Gs, Ww, Ww, Gg, Gg, Gll^Fmf, Gll^Fmf, Gg, Re, Re, Gg, Gg, Gg^Efm, Gg^Efm, Gg^Efm, Gg^Efm, Gg^Efm, Gg, Gg, Ds, Ds, Ds, Ww, Ww, Ww, Wwr, Wwr, Ww, Ww, Mm^Xm
Mm^Xm, Mm, Mm, Gs, Gs, Gs, Gs, Gs, Gs, Ww, Ww, Ww, Ww, Gg, Re, Re, Gg, Gg, Wwr, Gg, Gg, Gg, Ww, Gg^Efm, Ww, Gg^Efm, Ww, Ww, Ww, Ww, Ww, Ww, Gg, Gg, Gg, Ww, Ww, Ww
Mm^Xm, Mm, Mm, Mm, Mm, Gs, Gd, Gs, Gd, Gd, Gd, Ww, Ww^Bw/, Ww^Bw/, Ww, Gg, Ww, Ww, Wwr, Ww, Ww, Ww, Ww, Ww, Ww, Ww, Ww, Ww, Ww, Ww, Gg, Gg, Gg, Gg^Efm, Gg^Efm, Gg, Gg, Ww
Mm^Xm, Mm, Mm, Mm, Gll^Fmf, Gd, Gd, Gd, Gd, Gd, Re, Re, Gd^Vhr, Ww, Ww, Ww, Ww, Ww, Gs, Ww, Ww, Ww, Ds, Ww, Gg, Ww, Gg, Gg, Gg, Gg, Gll^Fmf, Gll^Fmf, Gll^Fmf, Gg, Gg^Efm, Gg^Efm, Gg^Efm, Mm^Xm
Mm^Xm, Mm, Gd, Gll^Fmf, Gd, Gd, Gd, Gd, Re, Re, Gd, Gd, Gd, Gd, Ds, Ww, Ds, Gs, Gs, Gs, Ds, Ds, Gg, Gg, Gg, Gg, Gg, Gg^Efm, Gg, Gg, Gll^Fmf, Gll^Fmf, Gll^Fmf, Gg^Efm, Gg^Efm, Gg^Efm, Gg^Efm, Mm^Xm
Mm^Xm, Mm, Mm, Gd, Ce, Gd, Gd, Re, Gd, Gd, Gd, Gd, Gd, Gd, Gd, Ds, Gs, Gs, Gs, Gs, Gg, Gg, Gg^Efm, Gg, Gll^Fmf, Gll^Fmf, Gll^Fmf, Gll^Fmf, Gll^Fmf, Gg, Gg, Gll^Fmf, Gll^Fmf, Gg, Gg, Gg^Efm, Gg^Efm, Mm^Xm
Mm^Xm, Mm, Mm, Re^Vct, Ce, Re^Vct, Re, Re, Gd, Gd, Gd, Gd, Gd, Gd, Gd, Gs, Gs, Gs, Gs, Gs, Gg, Gg, Gg^Efm, Gg^Efm, Gg, Gg, Gll^Fmf, Gg^Fet, Gll^Fmf, Gll^Fmf, Gg, Gll^Fmf, Gg, Gg, Gg, Gg, Gg, Mm^Xm
Mm^Xm, Mm, Ce, Ce, Ce, Ce, Re, Rd, Rd, Gd, Gd, Gd, Gd, Gd, Gd, Gd, Gd, Gs, Mm, Gll^Fmf, Gll^Fmf, Gll^Efm, Gg, Gg^Efm, Gg, Gll^Fmf, Gg, Gll^Fmf, Gg, Gll^Fmf, Gll^Fmf, Gg, Gg, Gg, Gg, Gg, Mm, Mm^Xm
Mm^Xm, Mm, Re^Vct, Ke, Ce, Ce, Re, Rd, Rd, Rd, Mm, Mm, Mm, Mm, Mm, Mm, Mm, Mm, Mm, Mm, Mm, Mm, Mm, Mm, Mm, Mm, Mm, Mm, Mm, Mm, Mm, Mm, Mm, Mm, Mm, Mm, Mm^Xm, Mm^Xm
Mm^Xm, Mm, Rd, Rd, Rd, Rd, Re, Rd, Rd, Rd, Mm^Xm, Mm^Xm, Mm^Xm, Mm^Xm, Mm^Xm, Mm^Xm, Mm^Xm, Mm^Xm, Mm^Xm, Mm^Xm, Mm^Xm, Mm^Xm, Mm^Xm, Mm^Xm, Mm^Xm, Mm^Xm, Mm^Xm, Mm^Xm, Mm^Xm, Mm^Xm, Mm^Xm, Mm^Xm, Mm^Xm, Mm^Xm, Mm^Xm, Mm^Xm, Mm^Xm, Mm^Xm
