Gll^Fdf, Gs, Gll^Fdf, Gll^Fdf, Gll, Gs, Gll, Gll^Fdf, Gll^Fdf, Gll^Fdf, Gll^Fdf, Gll, Ce, Ce, Gs, Re^Vct, Gs, Ce, Ce, Ce, Ce, Ce, Re^Eff, Re^Gvs, Re^Gvs, Re^Gvs, Re^Gvs, Re^Gvs, Re^Gvs, Re^Gvs, Re^Gvs, Re^Gvs, Rb
Gll, Gll^Fdf, Gll^Fdf, Gll^Fdf, Gs, Gs, Gs, Gll^Fdw, Gll^Fdw, Gll^Fdw, Gs, Ce, Gs, Gs, Re^Vct, Gs^Ecf, Re^Vct, Gll, Gll^Fdw, Gll^Fdf, Gll^Fdw, Gll^Fdf, Re^Vct, Re^Eff, Re^Eff, Re^Gvs, Re^Gvs, Re^Gvs, Re^Gvs, Re^Gvs, Rb, Rb, Re^Gvs
Rr, Gll, Gs, Gs, Rr, Gs, Ch, Ce, Gs, Gs, Re^Vct, Gs^Ecf, Re^Vct, Gs, Gs, Gs, Gll^Fdf, Gs, Gs, Gs, Gs, Gll^Fdw, Gs, Gs, Gs, Gll^Fdf, Gs^Vh, Re^Gvs, Rb, Rb, Re^Gvs, Re^Gvs, Re^Gvs
Gll, Rr, Rr, Rr, Gs, Rr, Rr, Gs, Rr, Rr, Rr, Rr, Rr, Gll, Gll^Fdw, Mm, Gll^Fdw, Re^Vct, Gs^Ecf, Re^Vct, Rr, Gs, Rr, Re^Vct, Rr, Rr, Rr, Rb, Re^Wm, Re^Gvs, Re^Gvs, Re^Gvs, Re^Gvs
Gll^Fdf, Gs, Gs, Gs, Gll, Ch, Gs, Rr, Gs^Ecf, Gll^Fdf, Gs, Gll^Fdw, Re^Vct, Rr, Rr, Rr, Rr, Rr, Rr, Rr, Re^Vct, Rr, Gs^Ecf, Rr, Re^Vct, Gll^Fdw, Gll^Fdf, Rr, Rr, Re^Eff, Re^Eff, Re^Gvs, Re^Gvs
Gll^Fdf, Gll^Fdf, Gs, Gs, Gll^Fdf, Ce, Ce, Re^Vct, Gs, Re^Vct, Gs^Ecf, Gs, Gll^Fdw, Gll^Fdf, Gs, Re^Vct, Gs, Re^Vct, Gs, Gs, Gs, Gs, Re^Vct, Gs, Gs, Gs, Ss, Gll^Fdf, Gll^Fdw, Rr, Rr, Re^Eff, Re^Eff
Gll, Gll, Gs, Gs, Gll^Fdw, Gs, Gll^Fdf, Ce, Gll^Fdf, Gll^Fdw, Hh, Re^Vct, Hh, Gs, Gll^Fdw, Gll^Fdf, Re^Vct, Gs^Ecf, Gll, Gll^Fdw, Gll^Fdw, Gs, Gll^Fdf, Gs, Ss, Ss, Ss^Vhs, Ss, Ss, Gll^Fdw, Rp, Rr, Rr
Gll^Fdf, Gll^Fdf, Gs, Gll^Fdw, Gll^Fdf, Gll, Gll^Fdw, Hh, Hh, Hh, Mm, Hh, Hh, Hh, Hh, Hh, Hh, Gll^Fdw, Gll^Fdf, Re^Vct, Gs, Gll^Fdf, Gll, Ss, Ss, Ss, Ss, Ss, Ss, Gll^Fdf, Rp, Rr^Vhc, Gll
Gll, Gll^Fdf, Gs, Gll^Fdw, Gs, Gs, Gll, Hh, Hh, Hh, Gll^Fdf, Hh, Hh, Mm, Hh, Mm, Hh, Hh, Gll^Fdf, Gll^Ecf, Re^Vct, Gs, Ss, Ss, Ss, Ss, Ss, Ss, Ss, Ss, Rp, Gll^Fdf, Gll^Fdf
Gll, Gs, Gs, Gs, Gll, Gll^Fdf, Gll^Fdw, Gs, Ce, Hh, Gll^Fdf, Hh, Hh, Hh, Gs, Hh, Hh, Gll^Fdw, Gs, Gs, Gll^Fdf, Gs, Ss, Ss, Ss, Ss, Chs, Chs, Ss, Gll^Fdf, Rp, Gll^Fdw, Gll
Gll, Gs, Gll^Fdf, Gs, Rp, Gll^Fdw, Rp, Gll^Fdf, Rp, Rp, Rp, Gll^Fdf, Gll, Re^Vct, Gs^Ecf, Re^Vct, Gll^Fdf, Hh, Re^Vct, Gll^Fdw, Gll^Fdf, Gll, Ss, Ss, Gs, Ss, Ww, Khs, Ww^Bw/r, Ww^Bw/r, Ww, Ww, Ww
Rp, Gll^Fdw, Rp, Rp, Gs, Rp, Gll^Fdf, Rp, Ce, Gll^Fdf, Gs, Rp, Rp, Rp, Rp, Rp, Rp, Gll^Fdf, Rp, Gll^Fdw, Rp, Rp, Rp, Gll^Fdf, Re^Vct, Ss, Ww^Bw/r, Ww^Bw/r, Ww, Ww, Ww, Ww, Ww
Gll^Fdf, Rp, Gs, Gs, Gs, Gll, Gs, Hh, Hh, Hh, Hh, Hh, Hh, Gll^Fdf, Hh, Gll^Fdf, Hh, Rp, Re^Vct, Rp, Gll^Fdf, Re^Vct, Gll^Fdw, Rp, Rp, Rp, Chw, Khw, Ww, Ww, Ww, Ww, Ww
Gll^Fdw, Gs, Gs, Gll, Gll^Fdw, Gll^Fdf, Gll, Hh, Hh, Hh, Mm, Hh, Hh, Hh, Mm, Hh, Hh, Hh, Gs, Gll^Fdw, Gll^Fdw, Gs, Gll^Fdf, Ww, Ww, Ww, Ww, Chw, Ww, Ww, Ww, Ww, Ww
Gs, Gll, Gs, Gs, Gll, Gll^Fdw, Gs, Hh, Hh, Hh, Hh, Hh, Hh, Hh, Hh, Hh, Mm, Hh, Hh, Gll^Fdf, Gll, Gll, Gs, Ww, Ww, Ww, Ww, Ww, Ww, Ww, Ww, Ww, Ww
