Mm, Mm, Mm, Mm, Mm, Hh, Hh, Gg, Rb, Gg, Gg, Gg, Gg, Gg, Gg, Gg, Gg, Gg, Gg, Re, Re, Re, Re, Re, Re, Gg, Gg, Gg, Gg, Gg, Gg, Gg, Gg, Gg, Gg, Gg, Gg, Gg, Gg, Gg, Gg, Gg, Gg
Mm, Mm, Mm, Mm, Hh, Hh, Rb, Rb, Rb, Gg, Hh, Re, Gg, Gg, Gd, Gg, Gg, Gg, Hh, Gg, Gg, Re, Re, Re, Re, Gg, Gg, Gg, Gll^Fmf, Gg, Gll^Fdw, Gg, Gg, Gg, Gd, Gg, Gd, Gg, Gll^Fmf, Gll^Fmf, Gll^Fp, Gg, Gg
Mm, Mm, Mm, Hh, Hh, Gg, Gg, Rb, Gg, Hh, Hh, Re, Gg, Gd, Gg, Gg, Gg, Gg, Hh, Hh, Gg, Gg, Re, Re, Re, Gg, Gll^Fdw, Gd, Gg, Gll^Fmf, Gll^Fdf, Gll^Fp, Gg, Gg, Gg, Gg, Gd, Gg, Gll^Fdw, Gll^Fdf, Gll^Fdw, Gg, Gg
Mm, Mm, Hh, Hh^Vhh, Gg, Gg, Gg, Gll^Fp, Gll^Fdf, Re, Re, Re, Gg, Gg, Co, Co, Co, Gg, Gg, Hh, Gg, Gd^Vhr, Re, Re, Re, Gg, Gll^Fdf, Gll^Fdw, Gll^Fdw, Gll^Fdf, Gg, Gg, Re^Vct, Co, Co, Gg, Gg, Gg, Gll^Fdf, Gll^Fdw, Gll^Fmf, Gll^Fmw, Gg
Hh, Hh, Hh, Gg, Gll^Fdw, Gg, Gll^Fdw, Gll^Fdw, Gll^Fmw, Gg, Gg, Gg, Gg, Co, Co, Ko, Co, Gg, Gg, Gg, Gg, Re, Re, Re, Re, Gg, Gg, Gll^Fdf, Gg, Gg, Gg, Gg, Co, Ko, Co, Co, Gg, Gll^Fdw, Gg, Gll^Fdw, Gll^Fdf, Gll^Fmf, Gg
Gg, Hh, Gg, Gg, Gll^Fp, Gg, Gg, Gll^Fdf, Gll^Fdf, Gg, Gd, Gg, Gg, Re^Vct, Gg, Co, Gg, Gg, Gd, Gd, Gg, Re, Re, Re, Gg, Gg, Rd, Gll^Fmw, Rd, Gll^Fdw, Gg, Co, Gg, Co, Gg, Gg, Hh, Gg, Gg, Gll^Fmw, Gg, Gll^Fmw, Gg
Gg, Gg, Gd, Gg, Gll^Fdw, Gll^Fdf, Gg, Gll^Fmw, Gg, Gg, Gd, Gd, Gg, Gg, Gg, Gg, Hh, Gg, Gg, Gd, Gg, Rd, Rd, Rd, Gg, Rd, Rd, Rd, Rd, Gll^Fdw, Gg, Gg, Gg, Gg, Gg, Gg, Ds, Gg, Ds, Gg, Gd, Gg, Gg
Ds, Gd, Gg, Gg, Ds, Gll^Fdw, Ds, Gg, Ds, Gg, Ds, Gg, Ds, Gg, Hh, Hh, Gg, Gg, Ds, Gg, Ds, Rd, Rd, Rd, Ds, Rd, Ds, Rd, Ds, Rd, Ds, Ds, Ds, Ds, Ds, Ds, Ds, Ds, Ds, Ds, Ds, Gd, Ds
Ww, Ds, Ds, Ds, Ww, Ds, Ww, Ds, Ww, Ds, Ww, Ds, Ds, Ds, Ds, Ds, Ds, Ds, Ds, Ds, Ds, Ds, Ds, Ds, Ds, Ds, Ds, Ds, Ds, Ds, Ww, Ds, Ww, Ds, Ww, Ds, Wwf, Ds, Ww, Ds, Ds, Ds, Ds
Ww, Ww, Ww, Ww, Wo, Ww, Wo, Ww, Wo, Ww, Wo, Ww, Wo, Ds, Ww, Ww, Wwr, Ds, Ww, Wwr, Ww, Ww, Ww, Ds, Ww, Ds, Ww, Ww, Wo, Ww, Wo, Wwf, Wo, Wo, Wo, Ww, Wo, Wwf, Wo, Ww, Wo, Ww, Wo
Wo, Wo, Wwr, Wo, Wo, Wo, Wo, Wo, Wo, Wo, Wo, Wo, Wo, Wo, Wo, Wo, Ww, Wwr, Ww, Ww, Wwr, Wwr, Ww, Ww, Ww, Wo, Wo, Wo, Wo, Wo, Wo, Ww, Wo, Wo, Wo, Wo, Ww, Wwr, Wo, Wo, Wo, Wo, Wo
Wo, Wo, Wo, Ww, Wwr, Wo, Ww, Wo, Wo, Wo, Wo, Wo, Wo, Wo, Wo, Wo, Wwr, Ww, Ww, Wo, Ww, Ww, Ww, Wwr, Ww, Ww, Ww, Wo, Wo, Wo, Ww, Ww, Wo, Wo, Wo, Wo, Wwr, Wo, Wo, Wo, Wo, Wo, Wo
Wo, Wo, Wwr, Ww, Wo, Ww, Wo, Ww, Ww, Ww, Ww, Wo, Wo, Wo, Wo, Wo, Wwr, Wwr, Wo, Wo, Ww, Ww, Ds, Ds, Ds^Dr, Ds, Ww, Wo, Wo, Wo, Ww, Wo, Wo, Wo, Wo, Wo, Ww, Ww, Ww, Wo, Wo, Wo, Wo
Wo, Wo, Ww, Wo, Wo, Wo, Wo, Ww, Ww^Vm, Ww, Wo, Wo, Wo, Wo, Wo, Wo, Ww, Ww, Ww, Ww, Ww, Wwr, Dd^Vdt, Chr, Gg, Chr, Ds, Ww, Ww, Ww, Ww, Wo, Wo, Wo, Wo, Wo, Ww^Vm, Wwr, Wo, Wwr, Wo, Wo, Wo
Wo, Wo, Ww^Vm, Wo, Wwr, Wo, Ww, Ww, Wo, Wo, Wo, Wo, Wo, Wo, Wo, Wo, Ww, Ww, Wwr, Ww, Ww, Ww, Wwr, Ds, Wwr, Ds, Ww, Ww, Ww, Ww, Ww, Wo, Wo, Wo, Wo, Wo, Wwr, Wo, Wo, Ww, Wo, Wo, Wo
Wo, Wo, Wwr, Ww, Wo, Ww, Wo, Wo, Wo, Wo, Wo, Wo, Wo, Wo, Wo, Wo, Wwr, Ww, Ww, Ww, Ww, Ww, Ww, Ww, Wwr, Ww, Wo, Wo, Ww, Ww, Wo, Ww, Wo, Wo, Wo, Wo, Ww, Ww, Wwr, Ww, Wo, Wo, Wo
Wo, Wo, Ww, Wo, Wo, Wo, Wo, Wo, Wo, Wo, Wo, Wo, Wo, Wo, Ww, Wo, Ww, Wwr, Ww, Wwr, Ww, Wwr, Ds, Wwf, Ds, Ww, Ww, Wo, Ww, Wo, Wo, Ww, Ww, Wo, Wo, Wo, Ww, Wo, Wo, Wo, Wo, Wo, Wo
Ds, Ww, Ds, Ww, Ds, Ww, Ww, Ww, Ww, Ww, Ww, Ww, Ds, Ww, Ds, Ww, Ds, Ds, Ds, Ds, Ds, Ds, Rd, Ds, Ds, Ds, Ds, Ww, Ww, Ww, Ww, Ww, Ww, Ww, Ww, Wo, Ww, Wo, Ww, Ww, Ds, Ww, Ww
Gg, Ds, Gg, Ds, Gg, Ds, Ds, Ds, Ds, Ds, Ds, Ds, Ds, Ds, Gg, Ds, Gg, Gg, Gg, Gg, Gg, Rd, Rd, Rd, Rd, Rd, Rd, Ds, Ds, Ds, Ds, Ds, Ds, Wwf, Ds, Ww, Ds, Ww, Ds, Wwf, Ds, Ds, Ds
Gg, Gg, Re, Gll^Fdf, Gg, Gg, Gg, Gg, Gg, Gg, Gg, Gg, Gg, Gll^Fdw, Gll^Fdw, Gg, Ch, Ch, Gg, Gg, Gg, Gg, Re, Re, Re, Re, Re, Re, Re, Gg, Gg, Gg, Gg, Ds, Ds, Ds, Re, Ds, Ds, Ds, Gg, Gg, Gg
Gg, Gll^Fdf, Re, Gll^Fdf, Gg, Gg, Gg, Gg, Gg, Gg, Ds, Ds, Ds, Gg, Gg, Ch, Kh, Re, Re, Gs^Vh, Re, Re, Re, Re, Gg, Re, Rp, Rr, Rp, Re, Gs^Vh, Gg, Gg, Gg, Gg, Gg, Re, Gg, Gll^Fdw, Gg, Gg, Gg, Gg
Gg, Gll^Fdw, Gll^Fdw, Gg, Re, Gs^Vh, Gll^Fdf, Gg, Gg, Ds, Ww, Ww, Ds, Gg, Gg, Ch, Ch, Re, Re, Re, Re, Re, Gg, Gg, Gll^Fmf, Gg, Gll^Fdf, Rr, Rr, Re, Gll^Fdw, Gll^Fmw, Gll^Fdf, Gll^Fdf, Gll^Fdf, Gll^Fp, Re, Gg, Gll^Fdw, Gll^Fdw, Gg, Gg, Gg
Gg, Gll^Fdw, Gll^Fdf, Gll^Fdf, Gll^Fdf, Re, Re, Gll^Fp, Gg, Ds, Ww, Ww, Ds, Gg, Gg, Gg, Gg, Ch, Gg, Re, Gg, Gg, Gll^Fdf, Gll^Fmf, Gll^Fmf, Gll^Fdf, Gg, Re, Rp, Re, Gll^Fmf, Gll^Fmf, Gg, Gll^Fdf, Gll^Fdw, Gg, Gg, Re, Gg, Gll^Fdw, Gg, Gg, Gg
Gg, Gll^Fdf, Re, Gll^Fp, Re, Gg, Gll^Fdw, Gll^Fdf, Gg, Ds, Ww, Ww, Ds, Gg, Gg, Gg, Gg^Efm, Gg^Efm, Gg, Gg, Gg, Gg, Gll^Fmw, Gll^Fdw, Gll^Fmf, Gll^Fmf, Gg, Rr, Re, Rr, Gll^Fdw, Gll^Fmf, Gll^Fmf, Gll^Fdf, Gll^Fmw, Gll^Fdf, Gg, Re, Gll^Fdw, Gll^Fdw, Gll^Fmf, Gg, Gg
Gll^Fdf, Gg, Gll^Fdf, Re, Gg, Gll^Fdf, Gg, Gg, Ds, Ds, Ww, Ww, Ds, Gg, Gg, Gg, Gg, Gg^Efm, Gg^Efm, Gg, Gg, Gll^Fdw, Gll^Fdf, Gll^Fdw, Gll^Fmf, Gll^Fmf, Gll^Fdf, Re, Rp, Re, Gll^Fdf, Gll^Fdf, Gll^Fdf, Gll^Fdw, Gg, Gg, Re, Re, Gg, Gll^Fdf, Gll^Fdf, Gll^Fmf, Gll^Fdf
Gll^Fdf, Re, Gll^Fdf, Gg, Gg, Gg, Gg, Gg, Ds, Ww, Ds, Ww, Ds, Gg, Gg, Gg, Hh, Gg, Gg, Gg, Gg, Gll^Fp, Gg, Gg, Gg, Gg, Gg, Rr, Rp, Re, Re, Gg, Re, Gg, Re, Gg, Gg, Gg, Gll^Fdf, Gg, Gll^Fmf, Gll^Fmf, Gll^Fdw
Gll^Fdf, Re, Gg, Gg, Gg, Gg, Gg^Efm, Gg, Gg, Ds, Gg, Ds, Gg, Gg, Hh, Hh, Mm, Hh, Gg, Gg, Gg, Gg, Gll^Fmf, Gll^Fmf, Gg, Re^Vct, Ce, Re, Rr, Rp, Re, Re, Gg, Ce, Gg, Re, Re, Gg, Gg, Gll^Fdf, Gll^Fdf, Gll^Fdf, Gg
Gg, Gg, Gll^Fdf, Gg, Gg, Gg, Gg, Gg, Gg, Gg, Gll^Fdw, Gg, Gg^Efm, Gg, Hh, Mm, Mm, Hh, Gg, Gg, Gg, Gg, Gll^Fdw, Gll^Fdw, Gll^Fmf, Ce, Ke, Ce, Re, Rr, Rp, Re, Ce, Ce, Ce, Gg, Gll^Fdf, Re, Gll^Fdf, Re, Re, Gg, Gg
Gg, Re, Re, Gll^Fdf, Gll^Fdf, Gg, Gg, Gg, Gg, Gg^Efm, Gll^Fdf, Gll^Fdf, Gg, Gg, Gg, Hh, Hh, Hh, Gg, Gg, Gg, Gg, Gll^Fdw, Gll^Fmf, Gll^Fmf, Gg, Gg, Ce, Re, Rp, Rr, Re, Gg, Ke, Gg, Re^Vct, Gll^Fdw, Gll^Fdw, Gll^Fdw, Gll^Fdf, Gll^Fp, Re, Gg
Gg, Gll^Fdf, Gll^Fdf, Re, Gg, Gll^Fdf, Gg, Gg, Gg, Gg, Gg, Gll^Fdf, Gg^Efm, Gg, Gg, Gg, Gg, Gg, Gg, Gg, Gg, Gg, Gg, Gll^Fmf, Gll^Fmf, Gll^Fmf, Gg, Gg, Gg, Rp, Re, Re, Gg, Gg, Gg, Gg, Gg, Gll^Fdf, Gll^Fdf, Gll^Fmf, Gg, Gg, Gg
