Mm, Mm, Mm, Mm, Mm, Mm, Mm, Mm, Mm, Mm, Mm, Mm, Mm, Mm, Mm, Mm, Ms, Mm, Mm, Mm, Mm, Mm, Mm, Mm, Mm, Mm, Mm, Re, Mm, Mm, Mm, Mm, Mm, Mm, Mm, Mm, Mm, Mm, Mm, Mm, Mm, Mm, Mm, Mm, Mm, Gg
Mm, Mm, Mm, Mm, Mm, Mm, Mm, Mm, Ms, Mm, Mm, Mm, Mm, Mm, Mm, Mm, Mm, Mm, Mm, Mm, Mm, Mm, Mm, Mm, Mm, Mm, Re, Re, Mm, Mm, Mm, Mm, Mm, Mm, Ms, Mm, Mm, Mm, Mm, Mm, Ms, Mm, Mm, Mm, Mm, Mm
Gg, Mm, Gll^Fp, Gg, Gll^Fp, Mm, Mm, Mm, Mm, Mm, Gg, Mm, Mm, Mm, Ms, Mm, Mm, Mm, Gd, Gll^Fmf, Gll^Fdw, Gll^Fmf, Aa, Mm, Re, Aa, Gg, Gg, Gg, Mm, Mm, Mm, Mm, Mm, Mm, Mm, Mm, Mm, Mm, Mm, Mm, Mm, Mm, Mm, Mm, Mm
Gll^Fp, Gll^Fmw, Gll^Fmw, Gll^Fmw, Gg, Gll^Fp, Gll, Gg, Gll^Fp, Gll^Fp, Gll, Gg, Gg, Aa, Aa, Mm, Gd, Gd, Gd, Gg, Gll^Fmf, Gll^Fmf, Gg, Aa, Re, Gg, Gg, Gg, Gg, Gg, Gg, Aa, Hh, Mm, Mm, Mm, Mm, Mm, Mm, Mm, Ha, Ha, Hh, Mm, Mm, Mm
Gll^Fmw, Gll^Fmw, Gg, Gg, Gg, Gll^Fp, Gll^Fp, Gll^Fmf, Gll^Fp, Gll^Fp, Gll^Fp, Gll^Fmw, Gll^Fmf, Gg, Gg, Gg, Gg, Aa, Gd, Gg, Gg, Gg, Re, Re, Gg, Gg, Gg, Gg^Esa, Gg, Gg, Gg, Hh, Mm, Mm, Mm, Mm, Hh, Mm, Mm, Hh, Ms, Ms, Ms, Hh, Mm, Mm
Gll^Fp, Gll^Fmw, Gg, Gll^Fp, Gll^Fp, Gll, Gll^Fp, Gll^Fp, Gll, Gll^Fmf, Gll^Fmw, Gll^Fmw, Gll^Fmf, Gg, Gg, Gg, Gg, Gg, Gg, Gd, Gg, Gg, Re, Gg, Gg, Gg^Esa, Gg, Gg, Gg, Gg^Esa, Gg, Hh, Hh, Ha, Hh, Hh, Hh, Mm, Hh, Hh, Hh, Ms, Hh, Hh, Mm, Mm
Gll^Fp, Gll^Fp, Gll^Fp, Gll^Fmf, Gll, Gll^Fmf, Gll^Fmf, Gll^Fp, Gll^Fp, Gg, Gll^Fp, Gg, Gll^Fmf, Gg, Gll, Gll, Gg, Gg, Gg, Gg, Gg, Gg, Gg, Gg, Gg, Gg, Gg, Gg^Esa, Gg^Esa, Gg, Gll^Fmf, Gg, Gg, Hh, Gg, Aa, Hh, Hh, Mm, Hh, Hh, Hh, Hh, Hh, Hh, Mm
Gll^Fp, Gll^Fp, Gll, Gg, Gg, Gll, Gll^Fp, Gll^Fmf, Gll^Fp, Gll^Fp, Gg, Gll^Fp, Gg, Gll^Fmf, Gll^Fp, Gll^Fmw, Gll^Fmw, Gg, Gll, Gg, Gg, Re, Gg, Gg^Esa, Gg, Gd, Gd, Gg, Gg, Gll^Fdw, Gg, Gg, Gg, Gg, Gg, Gg, Hh, Hh, Hh, Hh, Hh^Vhh, Hh, Hh, Mm, Hh, Gg
Gll^Fp, Gll^Fp, Gg, Gg^Ve, Gg, Gg, Gll^Fp, Gg, Gll^Fp, Gll^Fp, Gll^Fp, Gll, Gll^Fp, Gg, Gll^Fmf, Gll^Fp, Gll^Fmw, Gll^Fmw, Gll, Gg, Gg, Re, Gg, Gg, Gg, Gg, Gg, Gg, Gg, Gg, Gg, Gg, Gg, Gll^Fmf, Gll^Fmf, Gg, Gg, Hh, Ke, Ce, Ce, Hh, Hh, Hh, Hh, Gg
Gll^Fmw, Gll^Fp, Gll^Fmw, Gg, Gll^Fp, Gg, Gg, Gg, Gll^Fmw, Gll^Fmw, Gll^Fmf, Gll, Gg, Gll^Fmf, Gg, Gll^Fp, Gll^Fmf, Gll, Gll^Fp, Gg, Gg, Re, Gg, Gg, Gg, Gd, Gg, Gg, Gg, Gg, Gg, Gg^Esa, Gll^Fmf, Gg, Gg^Esa, Gg, Gg, Gg, Gg^Esa, Ce, Ce, Hh, Gg, Hh, Gg, Gg
Gll^Fp, Gll^Fp, Gll^Fmw, Gg, Gll^Fp, Gll^Fp, Gg, Gll^Fp, Gll^Fmw, Gg, Gll^Fmf, Gg, Gll^Fmf, Gll^Fp, Gll^Fp, Gll, Gg, Gll^Fp, Gll^Fp, Gg, Gg, Re, Gd^Vhr, Gg, Gg, Gg, Gg, Gg, Gll^Fmf, Gg, Gg, Gg, Gll^Fmf, Gll^Fdw, Gg, Gg, Gg, Gg^Esa, Gg, Gg, Gg, Gg, Gg, Gg, Gg, Gg
Gll^Fp, Gll^Fp, Gll^Fmw, Gll^Fmw, Gg, Gll^Fp, Gll^Fp, Gg, Gg, Gg, Gg, Gll^Fp, Gg, Gg, Gll^Fmf, Gll, Gll^Fmw, Gll^Fmw, Gg, Gg, Gg, Gg, Gg, Gg, Gg, Gg, Gg, Gg, Gg, Gll^Fdw, Gg, Gg, Gd, Gg, Gg, Gg, Gg, Gg, Gd, Gd, Gg, Gg, Gll^Fdf, Gll^Fp, Gg, Gg
Gll^Fp, Gll^Fp, Gg, Gll^Fp, Gll^Fmw, Gll^Fp, Gll, Gll^Fmf, Gll^Fmf, Gll^Fp, Gll, Gg, Gll^Fp, Gll^Fmf, Gg, Gll^Fmw, Gll^Fp, Gg, Gll^Fp, Gg, Gg, Gg, Ce, Ce, Ce, Gd, Gll^Fmf, Gg, Gg, Gg, Gg, Gg, Gd, Gg, Gg, Gg, Gg, Gd, Gg, Gg, Gg, Gg, Gg, Gll^Fp, Gg, Gg
Gll^Fp, Gll^Fp, Gll^Fp, Gll^Fmw, Gg, Gll, Gll^Fp, Gg, Gg, Gll^Fmf, Gg, Gll^Fp, Gg, Gll^Fp, Gll^Fmf, Gll^Fp, Gll^Fp, Gll^Fmf, Gg, Gg, Gg, Re, Ce, Ke, Ce, Gll^Fmf, Gll^Fdw, Gll^Fdf, Gg, Gg, Gg, Gg, Gg, Gg, Gg, Gg, Gg, Gg, Gg, Gg, Gg, Gg, Gg, Gll^Fp, Gll^Fmf, Gg
Gll^Fp, Gll^Fp, Gg, Gg, Gll^Fp, Gll^Fmw, Gll^Fmf, Gll^Fp, Gll, Gg, Gll^Fmf, Gll^Fp, Gll^Fp, Gg, Gg, Gll^Fmw, Gll^Fmw, Gg, Gg, Gg, Gg, Re, Ce, Ce, Gg, Gg, Gg, Gg, Gg, Gg, Gd, Gg, Gd, Gg, Gg, Gg, Gg, Gg, Hh, Hh, Hh, Gg, Gg, Gg, Gg, Gg
Gll^Fp, Gg^Ve, Gll, Cv, Cv, Gll^Fmw, Gll^Fmw, Gg, Gll^Fp, Gg, Gll, Gll^Fmf, Gll^Fp, Gll^Fp, Gg, Gg, Gll^Fmw, Gll^Fp, Gg, Gg, Gg, Re, Gg, Gg, Gg, Gg, Gd, Gg, Gg, Gg, Gd, Gg, Gll^Fdw, Gd, Gg, Gg, Gg, Gg, Hh, Mm^Xm, Hh, Gg, Gg, Gg, Gg, Gg
Gll^Fp, Gll^Fp, Cv, Kv, Cv, Gll^Fmf, Gg, Gll^Fmw, Gll^Fp, Gll^Fp, Gll, Gg^Ve, Gg, Gg, Gll^Fmf, Gll^Fp, Gll^Fp, Gg, Gg, Gg, Re, Re, Gg, Gg, Gg, Gg, Gg, Gg, Gg, Gg, Gg, Gg, Gll^Fmf, Gll^Fdf, Gg, Gg, Gg, Gg, Gg, Hh, Gg, Gg, Gg, Gg, Gg, Gg
Gll^Fp, Gll^Fp, Gll^Fp, Cv, Gll^Fp, Gll^Fmf, Gll^Fmf, Gg, Gll^Fp, Gll^Fmf, Gll^Fmf, Gll^Fmf, Gll^Fp, Gll, Gll, Gll^Fmf, Gg, Gg, Gg, Gg, Gg, Gg, Ce, Gg, Gg, Gg, Gg, Gll^Fdw, Gll^Fmf, Gg, Gg, Gg, Gg, Gg, Gg, Gg, Gg, Gg, Gg, Gg, Gg, Gg, Gd, Gg, Gg, Gg
Gll^Fp, Gll^Fp, Gll, Gll^Fp, Gll, Gg, Gll^Fp, Gll, Gg, Gg, Gg, Gll^Fp, Gll^Fmw, Gll^Fmw, Gll^Fmf, Gll^Fp, Gll, Gg, Gg, Gg, Re, Gg, Ce, Gg, Gg, Gg, Gg, Gll^Fdf, Gg, Gg, Gg, Gg, Gg, Gd, Gg, Gg, Gg, Gg, Gg, Gg, Gg, Gd, Gg, Gg, Gg, Gg
Gll^Fp, Gll^Fp, Gll^Fmw, Gll^Fmw, Gll^Fmf, Gg, Gll^Fmf, Gll^Fp, Gll, Gll^Fmw, Gll^Fp, Gll^Fmw, Gll^Fmf, Gll^Fp, Gg, Gll^Fmf, Gll^Fp, Gg, Gg, Re, Gg, Ce, Ke, Ce, Gg, Gg, Gg, Gg, Gg, Gg, Gg, Gg, Gg, Gd, Gg, Gg, Gll^Fp, Gg, Gll^Fp, Gg, Gg, Gd, Gg, Gg, Gg, Gg
Gll^Fp, Gll^Fp, Gll^Fmf, Gll^Fmf, Gll^Fmw, Gll^Fmf, Gll^Fp, Gll^Fp, Gll^Fmf, Gll, Gll^Fp, Gll^Fp, Gll^Fmf, Gll^Fmw, Gll^Fp, Gll^Fp, Gll, Gg, Re, Re, Gg, Ce, Ce, Ce, Gg, Gg, Gg, Gg, Gg, Gll^Fmf, Gll^Fdw, Gg, Gg, Gd, Gg, Gg, Gll^Fmf, Gll^Fp, Gg, Gg, Gg, Gd, Gg, Gg, Gg, Gg
Gll^Fp, Gll^Fp, Gg, Gll^Fp, Gll^Fmw, Gll, Gll, Gll^Fp, Gll^Fmf, Gll^Fmf, Gll, Gll, Gg, Gll^Fp, Gll^Fp, Gll^Fp, Gg, Gg, Re, Gd^Vhr, Gg, Gg, Gll^Fdf, Gg, Gg, Gg, Gg, Gg, Gg, Gll^Fdf, Gg, Gg, Gg, Gd, Gg, Gg, Gg, Gll^Fdf, Gg, Gg, Gg, Gd, Gg, Gg, Gg, Gg
Gll^Fp, Gll^Fp, Gll^Fp, Gll^Fp, Gll^Fp, Gll^Fmw, Gll^Fmf, Gll^Fmf, Gg, Gll^Fp, Gll^Fp, Gll^Fp, Gg, Gg, Gg, Gg, Gg, Re, Gg, Gg, Gg, Gll^Fmf, Gll^Fmf, Gg, Gg, Gd, Gd, Gd, Gg, Gg, Gg, Gg, Gg, Gg, Gg, Gg, Gg, Gg, Gg, Gg, Gg, Gg, Gg, Gg, Gg, Gg
Gll^Fp, Gll^Fp, Gll^Fp, Gll^Fp, Gll^Fmf, Gll^Fp, Gg, Gg, Gg, Gll^Fp, Gg, Gll^Fmw, Gll^Fmw, Gg, Gg, Gg, Gg, Gg, Gg, Gg, Gd, Gg, Gg, Gg, Gg, Gg, Gg, Gd, Gd, Gg, Gg, Gg, Gg, Gg, Gg, Gg, Gg, Gd, Gg, Gg, Gg, Gg, Gg, Gg, Gg, Gg
Gll^Fp, Gll, Gll, Gll^Fmf, Gll, Gll^Fp, Gg, Gg^Ve, Gll^Fmw, Gll^Fmw, Gg, Gg, Gg, Gg, Gd, Gg, Re, Gg, Gg, Gd, Gg, Gd, Gg, Gg, Gg, Gg, Gg, Gg, Gg, Gg, Gg, Gg, Gg, Gg, Gg, Gg, Gg, Gd, Gg, Gg, Gg, Gg, Ce, Gg, Gg, Gg
Gll^Fp, Gll^Fmf, Gg, Gg, Gll^Fp, Gll, Gg, Gg, Gll^Fmf, Gll^Fmw, Gg, Gg, Gd, Gd, Gd, Gg, Re, Gg, Re, Gg, Re, Gg, Re, Re, Re, Re, Gg, Re, Re, Gg, Re, Re, Re, Re, Gg, Gg, Gg, Gg, Gg, Gg, Gg, Ce, Ke, Ce, Gg, Gg
Gll^Fp, Gg, Gll^Fp, Gg, Gg, Gg, Gg, Gg, Gg, Gg, Gg, Gg, Gg, Gg, Re, Re, Gg, Gg, Gg, Re, Gg, Gg, Gg, Gg, Gg, Gg, Gg, Gg, Gg, Gg, Gg, Gg, Gg, Gg, Gg, Re, Re, Gg, Gg, Gg, Re, Gg, Gg, Ce, Gg, Re
Gll^Fp, Gll, Gll^Fp, Gll^Fp, Gll^Fmw, Gll, Gg, Gg, Gg, Gg, Re, Re, Gg, Re, Gg, Gg, Gg, Gg, Ds, Gg, Ds, Gg, Ds, Ds, Ds, Ds, Ds, Ds, Ds, Gg, Ds, Gg, Ds, Gg, Gg, Gg, Gg, Re, Gg, Re, Gg, Gg, Re, Gg, Gd^Vhr, Gg
Gll^Fp, Gg, Gg, Gg, Re, Gll, Re, Re, Gg, Re, Gg, Gg, Ds, Gg, Ds, Ds, Ds, Ds, Ww, Ds, Ww, Ds, Ww, Ww, Ww, Ww, Ww, Ww, Ww, Ds, Ww, Ds, Ww, Ds, Ds, Gd, Gg, Gg, Gg, Gg, Ce, Gg, Gg, Re, Re, Gg
Gg, Gg, Re, Re, Gg, Re, Gg, Gg, Ds, Gg, Ds, Ds, Ww, Ds, Ww, Ww, Ww, Ww, Wo, Ww, Wo, Ww, Wo, Wo, Wo, Wo, Wo, Wo, Wo, Ww, Wo, Ww, Wo, Ww, Ww, Ds, Ds, Gg, Gd^Vhr, Gg, Ce, Ke, Ce, Gg, Gg, Gg
Re, Gg, Gg, Gg, Gg, Gg, Ds, Ds, Ww, Ds, Ww, Ww, Wo, Ww, Wo, Wo, Wo, Wo, Wo, Wo, Wo, Wo, Wo, Wo, Wo, Wo, Wo, Wo, Wo, Wo, Wo, Wo, Wo, Wo, Wo, Ww, Ww, Ds, Ds, Gg, Gg, Ce, Gg, Gg, Gg, Gg
Gg, Gg, Ds, Gs^Vh, Ds, Ds, Ww, Ww, Wo, Ww, Wo, Wo, Wo, Wo, Wo, Wo, Wo, Wo, Wo, Wo, Wo, Wo, Wo, Wo, Wo, Wo, Wo, Wo, Wo, Wo, Wo, Wo, Wo, Wo, Wo, Wo, Wo, Ww, Ww, Ds, Ds, Gg, Ds, Gg, Gg, Gg
Ds, Ds, Ww, Ds, Ww, Ww, Wo, Wo, Wo, Wo, Wo, Wo, Wo, Wo, Wo, Wo, Wo, Wo, Wo, Wo, Wo, Wo, Wo, Wo, Wo, Wo, Wo, Wo, Wo, Wo, Wo, Wo, Wo, Wo, Wo, Wo, Wo, Wo, Wo, Ww, Ww, Ds, Ww, Ds, Ds, Ds
Ww, Ww, Wo, Ww, Wo, Wo, Wo, Wo, Wo, Wo, Wo, Wo, Wo, Wo, Wo, Wo, Wo, Wo, Wo, Wo, Wo, Wo, Wo, Wo, Wo, Wo, Wo, Wo, Wo, Wo, Wo, Wo, Wo, Wo, Wo, Wo, Wo, Wo, Wo, Wo, Wo, Ww, Wo, Ww, Ww, Ww
Wo, Wo, Wo, Wo, Wo, Wo, Wo, Wo, Wo, Wo, Wo, Wo, Wo, Wo, Wo, Wo, Wo, Wo, Wo, Wo, Wo, Wo, Wo, Wo, Wo, Wo, Wo, Wo, Wo, Wo, Wo, Wo, Wo, Wo, Wo, Wo, Wo, Wo, Wo, Wo, Wo, Wo, Wo, Wo, Wo, Wo
