Rr, Rr, Rr, Rr, Rr, Gg, Gg, Gg, Gg, Gg, Gll^Fdf, Gg, Gg, Gg, Gg, Gg, Ds, Wo, Wo, Wo, Wo, Wo, Wo, Wo, Wo, Wo, Wo, Wo, Wo, Wo, Wo, Wo, Wo, Wo, Wo, Wo, Wo, Wo, Wo, Wo, Ww, Wo, Ce, Ww, Ww^Bw|, Wo
Rr, Rr, Rr, Rr, Rp, Rr, Rp, Gd, Gll^Fmf, Gll^Fdf, Gg, Gs, Gs, Gd, Gll^Fdf, Gg, Ds, Ww, Ww, Wo, Wo, Wo, Wo, Wo, Wo, Wo, Wo, Wo, Wo, Wo, Wo, Wo, Wo, Wo, Wo, Wo, Wo, Wo, Ww, Ww, Ds, Ww, Ce, Ds, Rr, Ww
Gll^Fdf, Rr, Rp, Rp, Rp, Rr, Rp, Rp, Rr, Gll^Fdf, Gg, Gs, Gd, Gs, Gll^Fmf, Gd, Gd, Ds, Ds, Ww, Ww, Wo, Wo, Wo, Wo, Wo, Wo, Wo, Wo, Wo, Wo, Wo, Wo, Wo, Wo, Wo, Ww, Ww, Ds, Ds, Gg, Ds, Gg, Gg, Rr, Ds
Gg, Gd, Gd, Rr, Rp, Rr, Rr, Rp, Rp, Rr, Gg, Gg, Gg, Hh, Gll^Fdf, Gg, Gd, Gd, Gg, Ds, Ds, Ww, Ww, Ww, Ww, Wo, Wo, Wo, Wo, Wo, Wo, Wo, Ww, Wo, Ww, Ww, Ds, Ds, Gg, Gg, Gg, Gg, Gg, Gg, Rr, Gg
Gg, Gd, Gll^Fdf, Gd, Gg, Rr, Rr, Rr, Rp, Rp, Rr, Gg, Gg, Gg, Gd, Gd, Re, Gg, Gd, Gg, Gd, Ds, Gg, Ww, Gg, Ww, Ww, Ww, Ww, Ww, Ww, Ds, Ds, Ww, Ds, Ds, Gg, Gg, Gg, Gll^Fmf, Gg, Gg, Ce, Gg, Rr, Gg
Gg, Gll^Fmf, Gll^Fdf, Gs, Gs, Gll^Fdf, Gd, Rp, Rr, Rp, Rp, Rr, Rp, Gg, Gg, Gg, Re, Re, Re, Gg, Co, Gg, Ww, Ww, Gs, Gg, Gg, Gg, Gg, Gg, Ds, Ds, Gg, Ds, Gg, Gg, Gs, Gs, Gg, Gll^Fmf, Gg, Ce, Gg, Gg, Rr, Gg
Gg, Gg, Gg, Gs, Gg, Gs, Gg, Gd, Gg, Rr, Rr, Rp, Rp, Rr, Gg, Hh, Re, Re, Re^Vct, Co, Ko, Co, Ww, Ds, Gll^Fmf, Gs, Gs, Gg, Gll^Fdf, Gg, Gg, Gg, Gg, Gg, Gs, Gs, Gs, Gs, Gg, Gg, Gg, Gg, Rr, Rr, Gg, Gg
Gg, Re, Gg, Gll^Fdf, Gg, Gs, Gg, Re, Gg, Gd, Rr, Rr, Rr, Rr, Rp, Gg, Gd, Gd, Co, Co, Co, Co, Ww, Ds, Gs, Gs, Gll^Fmf, Gll^Fdf, Rb^Eff, Gll^Fdf, Gll^Fmf, Gg, Gs, Gs, Gg, Gs, Gg, Gg, Gg, Ce, Rr, Rr, Gll^Fdf, Gll^Fmf, Rr, Rr
Gg, Re, Gll^Fmf, Gg, Re, Gs, Gd, Gll^Fmf, Gg, Gd, Re, Rp, Rr, Rr, Rp, Rp, Rr, Gs, Gd, Gd^Ecf, Ww, Ww, Ds, Ds, Gll^Fmf, Gll^Fdf, Rb^Eff, Rb^Eff, Rb^Gvs, Rb^Eff, Rb^Eff, Gll^Fdf, Gg, Gg, Gg, Gg, Gg, Gg, Gg, Ce, Rr, Gll^Fmf, Rr, Rr, Gll^Fmf, Gg
Gg, Re, Re, Gll^Fdf, Re, Re, Gg, Gd, Gs, Gd, Gg, Gll^Fdf, Gs, Rr, Rr, Rp, Rp, Rr, Rr, Gd, Hh, Ds, Gs, Gs, Rb^Eff, Rb^Eff, Rb^Gvs, Rb^Gvs, Rb^Gvs, Rb^Gvs, Rb^Gvs, Rb^Eff, Rb^Eff, Gg, Ce, Ce, Ce, Gg, Gg, Gll^Fmf, Rr, Rr^Vhc, Rr, Rr, Rr, Gll^Fdf
Gg, Gg, Gg, Re, Gll^Fmf, Gs, Gs, Gs, Gg, Gg, Rb^Eff, Gs, Gs, Gg, Gd^Vhr, Rr, Rr, Rr, Rp, Rr, Rr, Rr, Rr, Rb^Eff, Rb^Eff, Rb^Gvs, Rb^Gvs, Rb^Gvs, Rb^Gvs, Rb^Gvs, Rb^Gvs, Rb^Gvs, Rb^Gvs, Rb, Ce, Ket, Gg, Gll^Fmf, Rr, Rr, Gll^Fdf, Rr, Rr, Gll^Fmf, Rr, Gll^Fmf
Gg, Gg, Gs, Gs, Gg, Gg, Gs, Gg, Re, Re, Re, Rb^Eff, Rb^Eff, Gs, Gs, Gg, Gg, Rr, Rr, Rp, Rp, Rr, Rr, Rr, Rr, Rb^Eff, Rb^Eff, Rb^Gvs, Rb^Gvs, Rb^Gvs, Rb^Gvs, Rb^Gvs, Rb^Gvs, Rb^Gvs, Ce, Gg, Gs^Vh, Rr, Gll^Fdf, Rr, Rr, Gll^Fmf, Rr, Gs^Vh, Gll^Fmf, Rr
Gg, Gs, Gs, Gs, Gs, Gs, Rb^Eff, Rb^Eff, Rb^Gvs, Re, Rb^Gvs, Rb^Gvs, Rb^Gvs, Rb^Eff, Rb, Gs, Gg, Gll^Fdf, Gll^Fdf, Rr, Rr, Rr, Rr, Rr, Rr, Rr, Rr, Rb^Eff, Rb^Eff, Rb^Gvs, Rb^Eff, Rb^Eff, Rb^Eff, Rb^Eff, Rr, Gg, Rr, Rr, Rr, Gll^Fmf, Rr, Rr, Rr, Gll^Fdf, Rr, Rr
Gg, Gg, Gg, Gg, Rb^Eff, Rb^Eff, Re, Rb^Gvs, Re^Vct, Rb^Gvs, Rb^Gvs, Rb^Gvs, Re, Re, Re, Re, Re, Gll^Fmf, Gll^Fdf, Gll^Fmf, Gll^Fmf, Gll^Fmf, Gg, Rr, Rr, Rr, Rr, Rr, Rr, Rb^Eff, Rr, Rr, Rr, Rr, Rr, Rr, Rr, Rr, Rr, Rr, Rr, Rr, Rr, Rr, Rr, Rr
Gg, Gg, Rb^Eff, Rb^Eff, Rb^Gvs, Rb^Gvs, Re^Ecf, Ce, Ko, Co, Co, Rb^Gvs, Rb^Gvs, Re, Rb, Re, Rb^Gvs, Rb^Eff, Rb^Eff, Gll^Fdf, Gg, Gll^Fmf, Rr, Rr, Rr, Rr, Rr, Rr, Rr, Rr, Rr, Rr, Rr, Rr, Rr, Rr, Rr, Rr, Rr, Rr, Rr, Rr, Rr, Rr, Rr, Rr
Rb^Eff, Rb^Eff, Rb^Gvs, Re, Rb^Gvs, Re, Rb^Gvs, Ce, Ce, Co, Rb^Gvs, Rb^Gvs, Rb^Gvs, Rb, Re, Rb^Gvs, Rb^Eff, Rb^Eff, Rr, Gll^Fmf, Rr, Rr, Rr, Rr, Rr, Rr, Rb^Eff, Rr, Rr, Rr, Rr, Rr, Rr, Rr, Ce, Rr, Rr, Rr, Gll^Fmf, Rr, Gll^Fdf, Rr, Rr, Rr, Rr^Vhc, Gg
Gg, Rb^Eff, Rb^Eff, Re, Rb^Gvs, Rb^Gvs, Rb^Gvs, Ce, Rb^Gvs, Rb^Gvs, Rb^Gvs, Rb^Gvs, Rb^Gvs, Rb, Rb, Re, Rr, Rr, Rr, Rr, Rr, Rr, Rr, Rr, Rb^Eff, Rb^Eff, Rb^Gvs, Rb^Eff, Rb^Eff, Rr, Gg, Gll^Fmf, Gg, Gg, Ce, Gs^Vh, Rr, Gll^Fdf, Ds, Rr, Rr, Gll^Fmf, Rr, Gll^Fmf, Gg, Gg
Gg, Gg, Gg, Rb^Eff, Rb^Eff, Re, Rb^Gvs, Rb^Gvs, Re, Re, Re, Re, Rb^Eff, Rb^Eff, Rr, Rr, Rr, Rr, Rr, Rr, Rr, Rr, Rb^Eff, Rb^Eff, Rb^Gvs, Rb^Gvs, Rb^Gvs, Rb^Gvs, Rb^Gvs, Rb^Eff, Rb^Eff, Gg, Gg, Gg, Ce, Ket, Ce, Rr, Rr, Ww, Rr, Rr^Vhc, Rr, Gll^Fdf, Rr, Gg
Gg, Gg, Gg, Gg, Gs, Rb^Eff, Rb^Eff, Rb^Gvs, Rb^Gvs, Rb^Gvs, Rb^Eff, Rb^Eff, Rr, Rr, Rr, Rr, Rr, Rr, Rb^Eff, Rr, Rb^Eff, Rb^Eff, Rb^Gvs, Rb^Gvs, Rb^Gvs, Rb^Gvs, Rb^Gvs, Rb^Wm, Rb^Gvs, Rb^Gvs, Rb^Gvs, Rb^Eff, Rb^Eff, Gg, Gg, Ce, Gg, Gg, Gg, Rr, Gll, Rr, Gll^Fmf, Rr, Gg, Rr
Gg, Gg, Gs, Gs, Gs, Gg, Gg, Rb^Eff, Rb^Eff, Rb^Eff, Rr, Rr, Rr, Rr, Rr, Rr, Rb^Eff, Rb^Eff, Rb^Gvs, Rb^Eff, Rb^Gvs, Rb^Gvs, Rb^Gvs, Rb^Gvs, Rb^Gvs, Rb^Gvs, Rb^Gvs, Rb^Gvs, Rb^Gvs, Rb^Gvs, Rb^Gvs, Rb^Gvs, Rb^Gvs, Rb^Eff, Rb^Eff, Gg, Gg, Gg, Gg, Ce, Ce, Gg, Gg, Gg, Ce, Gg
Gg, Gg, Gll^Fdf, Gll^Fmf, Gs, Gs, Gg, Gg, Rr, Rr, Rr, Rr, Rr, Rr, Gg, Rb^Eff, Rb^Eff, Rb^Gvs, Rb^Gvs, Rb^Gvs, Rb^Gvs, Rb^Gvs, Rb^Gvs, Rb^Gvs, Rb^Gvs, Rb^Gvs, Rb^Gvs, Rb^Gvs, Rb^Gvs, Rb^Gvs, Rb^Gvs, Rb^Gvs, Rb^Gvs, Rb^Gvs, Rb^Eff, Rb^Eff, Gg, Gg, Gg, Gg, Gg, Gg, Gg, Ce, Gg, Gg
Gg, Gg, Gs, Gs, Gs, Gg, Gg, Gg, Rr, Rr, Rr, Rr, Rr, Gg, Hh, Gg, Gg, Rb^Eff, Rb^Eff, Rb^Gvs, Rb^Gvs, Rb^Gvs, Rb^Gvs, Rb^Gvs, Rb^Gvs, Rb^Gvs, Rb^Gvs, Rb^Gvs, Rb^Gvs, Rb^Gvs, Rb^Gvs, Rb^Gvs, Rb^Eff, Rb^Eff, Gg, Gll^Fdf, Gll^Fmf, Gll^Fdf, Gg, Gg, Gg, Gg, Gg, Gg, Gg, Gg
Gg, Gg, Gs, Gll^Fmf, Gg, Gg, Rr, Rr, Rr, Rr, Rr, Rr, Gg, Hh, Hh, Hh, Gg, Gg, Gg, Rb^Eff, Rb^Eff, Rb^Gvs, Rb^Gvs, Rb^Gvs, Rb^Gvs, Rb^Gvs, Rb^Gvs, Rb^Gvs, Rb^Gvs, Rb^Gvs, Rb^Eff, Rb^Eff, Gg, Gll^Fdf, Gll^Fdf, Gll^Fmf, Gg, Gg, Gll, Gg, Gll, Gll, Gll^Fmf, Gll^Fmf, Gll^Fmf, Gll^Fmf
Gg, Gg, Gll^Fmf, Gg, Rr, Rr, Rr, Rr, Rr, Rr, Gg, Gg, Gg, Gg, Gg, Gg, Gg, Gll^Fmf, Gll^Fdf, Gll^Fdf, Gg, Rb^Eff, Rb^Eff, Rb^Gvs, Rb^Gvs, Rb^Wm, Rb^Gvs, Rb^Gvs, Rb^Eff, Rb^Eff, Gg, Gg, Gg, Gll^Fmf, Hh, Hh, Gll, Gll, Gll^Fmf, Gll, Gll^Fmf, Gll^Fmf, Gll^Fmf, Gll^Fmf, Gll^Fmf, Gll^Fmf
Gg, Gll^Fdf, Gll^Fmf, Gg, Rr, Rr, Rr, Rr, Gg, Gg, Gll^Fmf, Gg, Gs, Gg, Gg, Re, Re, Gg, Gg, Gg, Gg, Gs, Gs, Rb^Eff, Rb^Eff, Rb^Gvs, Rb^Eff, Rb^Eff, Gll^Fdf, Gg, Gg, Gg, Gg, Gg, Gll, Gll, Gg, Gll^Fdf, Gll^Fmf, Gll^Fmf, Gll^Fmf, Gll^Fdf, Gll^Fdf, Gg, Gll^Fmf, Gll^Fmf
Gg, Gg, Gg, Rr, Rr, Rr, Rr, Gg, Gg, Gg, Gll^Fmf, Hh, Gs, Gll^Fmf, Gll^Fmf, Gg, Gll^Fmf, Re, Re, Gg, Gg, Gs, Gs, Gg, Gg, Rb^Eff, Gg, Gll^Fdf, Gll^Fmf, Gg, Gll^Fmf, Gg, Gll^Fmf, Gll, Gll^Fmf, Gg, Gg, Gll^Fmf, Gll^Fdf, Gg, Gll^Fmf, Gll^Fdf, Gll^Fdf, Gg, Gll^Fmf, Gll^Fmf
Gg, Gg, Rr, Rr, Rr, Rr, Gg, Gg, Gll^Fmf, Gll^Fdf, Gg, Gs, Gg, Gg, Re, Re, Re, Re, Gg, Gg, Gll, Gs, Gll^Fmf, Gg, Gg, Gg, Gll^Fmf, Gll^Fdf, Gll^Fdf, Gll^Fdf, Gg, Gll^Fmf, Gll^Fmf, Gll^Fdf, Gll^Fmf, Gll^Fmf, Gg, Gll^Fdf, Gll^Fdf, Gll^Fdf, Gll, Gll^Fmf, Gll^Fmf, Gll^Fmf, Gg, Gll^Fmf
Gg, Gg, Rr, Rr, Rr, Rr, Gg, Gg, Gg, Gg, Gg, Gll^Fmf, Gg, Gg, Gg, Gg, Gll^Fdf, Gg, Gll, Gll, Gll^Fmf, Gll^Fmf, Gll^Fmf, Gll^Fdf, Gll^Fmf, Gg, Gg, Gll^Fdf, Gg, Gll^Fmf, Gg, Gll^Fdf, Gll^Fdf, Gll^Fdf, Gll^Fdf, Gll^Fdf, Gll^Fdf, Gll^Fmf, Gg, Gll^Fdf, Gll^Fdf, Gll^Fdf, Gll^Fmf, Gll^Fmf, Gll^Fdf, Gll^Fmf
Gg, Gg, Rr, Rr, Rr, Rr, Gg, Gg, Gg, Gg, Gs, Gs, Gs, Gg, Gs, Gll^Fdf, Gll^Fdf, Gg, Gll^Fmf, Gll^Fmf, Gll^Fmf, Gg, Gll^Fdf, Gg, Gg, Gll^Fdf, Gg, Gg, Gg, Gll^Fmf, Gll^Fdf, Gg, Gll^Fdf, Gg, Gg, Gll^Fmf, Gll^Fmf, Gll^Fdf, Gll^Fdf, Gll, Gll^Fdf, Gll^Fmf, Gg, Gll^Fmf, Gll^Fmf, Gll^Fmf
Gg, Rr, Rr, Rr, Rr, Gg, Gg, Gg, Gg, Gg, Gg, Gs, Gs, Gs, Gg, Gg, Gg, Gg, Gll^Fmf, Gll^Fmf, Gll^Fdf, Gll^Fdf, Gg, Gg, Gll^Fmf, Gll^Fmf, Cv, Cv, Cv, Gg, Gg, Gll^Fdf, Gg, Gll^Fdf, Gll^Fdf, Gll^Fdf, Gg, Gll^Fdf, Gg, Gg^Ve, Gg, Gg, Gg, Gll^Fdf, Gll^Fmf, Gll^Fmf
Rr, Rr, Rr, Rr, Gg, Gg, Gg, Gg, Gll^Fmf, Gg, Gg, Gll^Fmf, Gg, Gs, Gll, Gg, Gll, Gg, Gll^Fmf, Gll^Fdf, Gll^Fdf, Gll^Fmf, Gll^Fdf, Gg, Gll^Fmf, Gll^Fmf, Cv, Kv, Gll^Fmf, Gll^Fmf, Gg^Ve, Gg, Gg, Gll^Fmf, Gll^Fdf, Gg, Gll^Fmf, Gg, Gll^Fdf, Gll, Gll^Fmf, Gll^Fdf, Gll^Fdf, Gg, Gll, Gll^Fmf
Rr, Rr, Rr, Rr, Gg, Gg, Gg, Gll^Fdf, Gll^Fdf, Gg, Gg, Gg, Gll, Gll, Gll^Fmf, Gll^Fmf, Gll^Fmf, Gg, Gll^Fmf, Gll^Fdf, Gll^Fmf, Gll^Fdf, Gll^Fmf, Gll^Fdf, Gll^Fdf, Gll^Fmf, Gll^Fmf, Cv, Gll^Fmf, Gll^Fmf, Gg, Gg, Gll^Fmf, Gg, Gg, Gg, Gll^Fdf, Gll^Fdf, Gll^Fmf, Gll^Fdf, Gll^Fmf, Gll^Fdf, Gg, Gg, Gll^Fmf, Gll^Fmf
Rr, Rr, Rr, Gg, Gg, Gg, Gg, Gg, Gg, Gg, Gll, Gll, Gll, Gll^Fmf, Gll^Fdf, Gll^Fdf, Gll^Fdf, Gll^Fdf, Gg, Gg, Gg, Gg, Gg, Gg, Gll^Fmf, Gg, Gll^Fdf, Gll^Fmf, Gg, Gg, Gll^Fdf, Gll^Fmf, Gll^Fdf, Gll^Fdf, Gll^Fdf, Gll^Fdf, Gll^Fmf, Gll^Fmf, Gll^Fmf, Gll^Fmf, Gg, Gll^Fmf, Gg, Gll^Fdf, Gll^Fdf, Gll^Fmf
