Wo, Wo, Wo, Wo, Wo, Wo, Wo, Wo, Wo, Wo, Wo, Wo, Wo, Wo, Wo, Wo, Wo, Wo, Gg, Gg, Gg, Rr, Gg, Gg, Gs, Gg, Gs, Gd, Gd, Gd, Gd, Gd, Gd, Gd, Gd, Gd, Gd, Gd, Gd, Gd, Gd, Gd, Gd, Gd, Gs, Gd, Gs, Gs, Gd, Gd, Gd, Gd, Gd, Gd, Gd, Gd, Gd, Gd, Gd, Gd, Gd, Gd, Gd, Gd
Wo, Wo, Wo, Wo, Wo, Wo, Wo, Wo, Wo, Wo, Wo, Wo, Wo, Wo, Wo, Wo, Wo, Wo, Gs, Gs, Rr, Rr, Gs, Gs, Gs, Gs, Gll^Fmf, Gs, Gs, Gd, Gd, Gd, Gd, Gs, Gd, Gd, Gs, Gd, Gs, Gd, Gs, Gd, Gs, Gs, Gd, Gs, Gd, Gd, Gd, Gd, Gd, Gd, Gs, Gs, Gd, Gd, Gd, Gd, Gd, Gd, Gd, Gd, Gs, Gd
Wo, Wo, Wo, Wo, Wo, Wo, Wo, Wo, Wo, Wo, Wo, Wo, Wo, Wo, Wo, Wo, Wo, Gg, Gs, Gs, Rr, Gs, Gd, Gd, Gd, Gs, Gll^Fmf, Gll^Fmf, Gll^Fmf, Gd, Gs, Gd, Gd, Gs, Gd, Gd, Gd, Gs, Hh, Gs, Gs, Gs, Gs, Gd, Gd, Gd, Gll^Fmw, Gd, Gll^Fmf, Gd, Gd, Gs, Gd, Gs, Gs, Gd, Gd, Gd, Gll^Fmf, Gd, Gd, Gs, Gd, Gd
Wo, Wo, Wo, Wo, Wo, Wo, Wo, Wo, Wo, Wo, Wo, Wo, Wo, Wo, Wo, Wo, Wo, Gg, Gg, Rr, Gg, Gd, Gs, Gs, Gd, Gs, Gs, Gll^Fmf, Gs, Gs, Gs, Gs, Gs, Gd, Gd, Gd, Gd, Hh, Gg, Hhd, Hh, Gd, Gs, Gs, Gll^Fmf, Gll^Fdf, Gll^Fdf, Gll^Fmw, Gll^Fmw, Gd, Gd, Gd, Gd, Gd, Gs, Gd, Gd, Gs, Gll^Fmw, Gll^Fdf, Gd, Gs, Gs, Gd
Wo, Wo, Wo, Wo, Wo, Wo, Wo, Wo, Wo, Wo, Wo, Wo, Wo, Wo, Wo, Wo, Wo, Gs, Gg, Rr, Gg, Gs, Gs, Gd, Gs, Gs, Gs, Gs, Gs, Gs, Gg, Gs, Gs, Gd, Gs, Gs, Gs, Gg, Gs, Hhd, Hhd, Gd, Gs, Gd, Gd, Gll^Fdf, Gll^Fdf, Gll^Fmf, Gll^Fmw, Gll^Fmw, Gd, Gd, Gd, Gd, Gd, Gd, Gd, Gs, Gll^Fmw, Gll^Fmw, Gll^Fmw, Gd, Gd, Gd
Wo, Wo, Wo, Wo, Wo, Wo, Wo, Wo, Wo, Wo, Wo, Wo, Wo, Wo, Wo, Wo, Wo, Gg, Gs, Rr, Rr, Gs, Gg, Gs, Gg, Co, Co, Co, Gs, Gs, Gg, Gd, Gs, Gs, Gs, Gs, Gs, Gs, Gs, Gs, Gs, Hhd, Gd, Gd, Gd, Gll^Fmf, Gs, Gs, Gs, Gs, Gs, Gs, Gs, Gd, Hh, Gd, Gd, Gs, Gll^Fmf, Gll^Fdf, Gll^Fdf, Gll^Fmw, Gll^Fmf, Gd
Wo, Wo, Wo, Wo, Wo, Wo, Wo, Wo, Wo, Wo, Wo, Wo, Wo, Wo, Wo, Wo, Wo, Wo, Ww, Gg, Gs, Rr, Gg, Gg, Re^Vct, Co, Co, Ko, Gs, Gs, Gs, Gd, Gs, Gs, Gll^Fmf, Gll^Fmf, Gll^Fmw, Gll^Fmw, Gll^Fmf, Gs, Gs, Gg, Gg, Gd, Gs, Gs, Gs, Gs, Gs, Gs, Gll^Fdf, Gs, Gs, Gs, Gd, Hh, Hhd, Gs, Gd, Gd, Gd, Gll^Fmf, Gd, Gd
Wo, Wo, Wo, Wo, Wo, Wo, Wo, Wo, Wo, Wo, Wo, Wo, Wo, Wo, Wo, Wo, Wo, Wo, Ww, Gg, Gs, Rr, Rr, Gs, Gs, Gg, Gg, Co, Gg, Gs, Gs, Gd, Gd, Gs, Gs, Gll^Fmf, Gll^Fmw, Gll^Fmf, Gs, Gs, Gd, Gs, Gg, Gs, Gs, Gs, Gll^Fmf, Gs, Gll^Fmw, Gs, Gll^Fmw, Gll^Fmf, Gs, Gs, Gd, Hhd, Hhd, Gd, Gd, Gd, Gs, Gd, Gs, Rr
Wo, Wo, Wo, Wo, Wo, Wo, Wo, Wo, Wo, Wo, Wo, Wo, Wo, Wo, Wo, Wo, Wo, Wo, Ww, Gg, Gs, Gg, Rr, Gg, Gs, Gs, Gg, Gg, Gg, Gs, Gs, Gg, Rr, Gd, Gs, Gs, Gs, Gs, Gs, Gd, Gs, Gs, Gs, Gs, Gs, Gs, Gd, Gll^Fmf, Gll^Fmf, Gll^Fmw, Gll^Fmw, Gll^Fmf, Gs, Gs, Gs, Gd, Gs, Hhd, Gs, Gs, Gs, Gs, Rr, Rr
Wo, Wo, Wo, Wo, Wo, Wo, Wo, Wo, Wo, Wo, Wo, Wo, Wo, Wo, Wo, Wo, Wo, Wo, Ww, Wwr, Gg, Gs, Gg, Rr, Rr, Gg, Re^Vct, Gs, Rr, Gs, Rr, Rr, Gd^Vhr, Rr, Rr, Gg, Gg, Gs, Gs, Gs, Gs, Gs, Gll^Fmw, Gs, Gs, Gs, Gs, Gs, Gs, Gll^Fdf, Gs, Gll^Fmf, Gs, Gs, Gg, Gg, Gg, Hh, Gd, Gs, Rr, Rr, Rr, Rr
Wo, Wo, Wo, Wo, Wo, Wo, Wo, Wo, Wo, Wo, Wo, Wo, Wo, Wo, Wo, Wo, Wo, Wo, Ww, Ww, Ww, Gg, Ww, Gg, Gg, Rr, Rr, Rr, Gg, Rr, Gg, Gg, Gs, Gs, Gs, Rr, Rr, Rr, Rr, Gs, Gg, Gll^Fmw, Gll^Fmw, Gll^Fmw, Gd, Gd, Gg, Gg, Re^Vct, Gs, Gs, Gs, Gs, Gg, Gs, Gg, Gs, Gd, Gd, Gs, Rr, Rr, Rr, Rr
Wo, Wo, Wo, Wo, Wo, Wo, Wo, Wo, Wo, Wo, Wo, Wo, Wo, Wo, Wo, Wo, Wo, Wo, Wo, Ww, Wo, Ww, Wo, Ww, Ww, Gg, Ww^Bsb|, Gg, Gg, Gg, Gg, Gs, Gd, Gg, Gg, Gg, Gs, Gs, Gs, Rr, Rr, Gs, Gs, Gs, Gg, Gg, Co, Co, Co, Gg, Gs, Gs, Gs, Gd, Gs, Gs, Gs, Gs, Gs, Rr, Rr, Rr, Rr, Rr
Wo, Wo, Wo, Wo, Wo, Wo, Wo, Wo, Wo, Wo, Wo, Wo, Wo, Wo, Wo, Wo, Wo, Wo, Wo, Wo, Wo, Wo, Wo, Wo, Wo, Ww, Ww^Bw|r, Ww, Ww, Ww, Ww, Gg, Gg, Gd, Gg, Gg, Gs, Gs, Gg, Gs, Gs, Rr, Rr, Gs, Gs, Gg, Co, Ko, Co, Co, Gs, Gs, Gd, Gs, Gll^Fmw, Gll^Fmw, Gs, Gs, Rr, Rr, Rr, Rr, Rr, Gs
Wo, Wo, Wo, Wo, Wo, Wo, Wo, Wo, Wo, Wo, Wo, Wo, Wo, Wo, Wo, Wo, Wo, Wo, Wo, Wo, Wo, Wo, Wo, Wo, Wo, Wo, Rp, Wo, Wo, Wo, Wo, Ww, Ww, Ww, Ww, Gg, Ww, Gg, Gs, Gg, Gg, Gs, Gs, Rr, Gg, Gs, Gg, Co, Gs, Gs, Gs, Gg, Gd, Gs, Gs, Gs, Rr, Rr, Rr, Rr, Rr, Rr, Gs, Gs
Wo, Wo, Wo, Wo, Wo, Wo, Wo, Wo, Wo, Wo, Wo, Wo, Wo, Wo, Wo, Wo, Wo, Wo, Wo, Wo, Wo, Wo, Wo, Wo, Wo, Rp^Dr, Rp, Chr, Wo, Wo, Wo, Wo, Wo, Ww, Wo, Ww, Ww, Ww, Ww, Gs, Gg, Gg, Gs, Rr, Rr, Gg, Gs, Gd, Gd, Gs, Gs, Gd, Gs, Gs, Rr, Rr, Rr, Rr, Rr, Rr, Rr, Gs, Gs, Gs
Wo, Wo, Wo, Wo, Wo, Wo, Wo, Wo, Wo, Wo, Wo, Wo, Wo, Wo, Wo, Wo, Wo, Wo, Wo, Wo, Wo, Wo, Wo, Wo, Wo, Wo, Ww^Bsb|, Wo, Wo, Wo, Wo, Wo, Wo, Wo, Wo, Wo, Wo, Wo, Wo, Ww, Ww, Gg, Gs, Gs, Gs, Rr, Ww^Bsb\, Wwr, Ww, Gd, Gs, Gs, Rr, Rr, Rr, Rr, Rr, Rr, Rr, Rr, Gg, Gg, Gg, Gs
Wo, Wo, Wo, Wo, Wo, Wo, Wo, Wo, Wo, Wo, Wo, Wo, Wo, Wo, Wo, Wo, Wo, Wo, Wo, Wo, Wo, Wo, Ww, Ww, Ww, Ww, Rrc, Ww, Ww, Wo, Wo, Wo, Wo, Wo, Wo, Wo, Wo, Wo, Wo, Wo, Wo, Ww, Ww, Gg, Wwr, Ww, Gs, Rr, Rr, Gs, Rr, Rr, Rr, Rr, Rr, Rr, Rr, Rr, Gg, Gg, Gll^Fmf, Gg, Gg, Gs
Wo, Wo, Wo, Wo, Wo, Wo, Wo, Wo, Wo, Wo, Wo, Wo, Wo, Wo, Wo, Wo, Wo, Wo, Wo, Wo, Ww, Ww, Gg, Ch, Ch, Rp^Dr, Rrc, Ch, Ch, Ww, Ww, Wo, Wo, Wo, Wo, Wo, Wo, Wo, Wo, Wo, Wo, Wo, Wo, Ww, Ww, Gs, Gg, Gs, Rr, Rr, Rr, Rr, Rr, Rr, Rr, Rr, Gs, Gg, Gg, Gll^Fmf, Gll^Fmf, Gg, Gll^Fmf, Gg
Wo, Wo, Wo, Wo, Wo, Wo, Wo, Wo, Wo, Wo, Wo, Wo, Wo, Wo, Wo, Wo, Wo, Wo, Ww, Ww, Gg, Gg, Gg, Gg, Gg, Gg, Rrc, Rr^Vhc, Gg, Ch, Ww, Wo, Wo, Wo, Wo, Wo, Wo, Wo, Wo, Wo, Wo, Wo, Wo, Wo, Ww, Ww, Rr, Rr, Rr, Rr, Rr, Rr, Rr, Rr, Gg, Gg, Gs, Gg, Gg, Gll^Fmf, Gg, Gg, Gll^Fmf, Gll^Fmf
Wo, Wo, Wo, Wo, Wo, Wo, Wo, Wo, Wo, Wo, Wo, Wo, Wo, Wo, Ch, Wo, Ww, Ww, Gg, Gg, Gll^Fmf, Gll^Fmf, Gg, Gg, Rr^Vhc, Gg, Rrc, Gg, Gg, Gg, Gg, Ww, Wo, Wo, Wo, Wo, Wo, Wo, Wo, Wo, Wo, Wo, Wo, Wo, Ww^Bsb/, Ww^Bsb/, Rr, Rr, Rr, Rr, Rr, Rr, Rr, Gg, Gg, Gll^Fmw, Gll^Fmw, Gg, Gll^Fmw, Gll^Fmf, Gll^Fmf, Gll^Fmf, Gll^Fmf, Gg
Wo, Wo, Wo, Wo, Wo, Wo, Wo, Wo, Wo, Wo, Ce, Ce, Ch, Ch, Ww, Ch, Ch, Ch, Gg, Gg, Gll^Fmf, Gll^Fdf, Gll^Fdf, Gg, Rrc, Rrc, Rr^Vhc, Gg, Gll^Fdf, Gll^Fp, Gg, Ww, Wo, Wo, Wo, Wo, Wo, Wo, Ww, Ww, Ww, Wo, Wo^Bw/r, Wo^Bw/, Wo, Ww, Ww, Rr, Rr, Rr, Rr, Rr, Rr, Rr, Gg, Gll^Fmw, Gg, Gll^Fmw, Gg, Gg, Gg, Gg, Gg, Gg
Wo, Wo, Wo, Wo, Wo, Wo, Wo, Wo, Wo, Wo, Wo, Wo, Wo, Wo, Wo, Ww, Ww, Ds, Ds, Gg, Gg, Gll^Fdf, Gg, Rrc, Gg^Efm, Gg^Efm, Gg, Gg, Gll^Fp, Gll^Fmf, Gg, Ww, Ww, Wo, Wo, Wo, Wo, Ww, Rp, Rp, Rp, Ww^Bsb/, Wo, Wo, Wo, Wo, Ww^Bsb/, Rr, Gg, Gd^Vhr, Gg, Rr, Rr, Rr, Rr, Gg, Gg, Gg, Gd, Hhd, Hhd, Hh, Gg, Gg
Wo, Wo, Wo, Wo, Wo, Wo, Wo, Wo, Wo, Wo, Wo, Wo, Wo, Wo, Wo, Wo, Wo^Bw/, Ww, Ds, Gg, Rrc, Gg, Rrc, Rrc, Gg^Efm, Gg^Efm, Ds, Ds, Ds, Gll^Fmf, Gg, Ch, Ww, Wo, Wo, Wo, Wo^Bsb/, Rp, Ch, Chr, Ww, Ww, Wo, Wo, Wo^Bw/r, Wo^Bsb/, Ww, Gg, Gg, Gg, Gg, Rr, Rr, Rr, Rr, Gg, Gs, Gg, Gg, Gg, Gg, Hh, Hh, Gg
Wo, Wo, Wo, Wo, Wo, Wo, Wo, Wo, Wo, Wo, Wo, Wo, Wo, Wo, Wo, Wo, Wo, Ww^Bw\, Ds, Rrc, Ch, Rrc, Ch, Rrc, Rr^Vhc, Gg^Efm, Ds, Ww, Ds, Gg, Gg, Chr, Chr, Ww, Ww^Bsb/, Wwr, Wo, Ww, Chr, Kh, Ww, Wo, Wo^Bw/, Wo^Bsb/, Wo, Wo, Wo, Ww, Gg, Gg, Gg, Gg, Rr, Rr, Rr, Rr, Gg, Gg, Co, Co, Co, Gg, Gg, Gg
Wo, Wo, Wo, Wo, Wo, Wo, Wo, Wo, Wo, Wo, Wo, Wo, Wo, Wo, Wo, Wo, Wo^Bw/, Ww, Ds, Rrc, Ch, Kh, Ch, Rrc, Rrc, Gg^Efm, Gll^Fp, Gll^Fp, Gll^Fmf, Gg, Gg, Rr^Vhc, Rrc, Rrc, Ww, Wo, Wo, Ww, Rp, Ch, Rp, Ww^Bsb/, Wo, Wo, Wo, Wo, Wo, Ww, Gg, Gg, Gg, Gg, Rr, Rr, Rr, Rr, Gg, Gg, Co, Ko, Co, Gg, Gg, Gg
Wo, Wo, Wo, Wo, Wo, Wo, Wo, Wo, Wo, Wo, Wo, Wo, Wo, Wo, Wo, Wo, Wo, Ww^Bw\, Ds, Rrc, Ch, Ch, Ch, Rrc, Rrc, Rrc, Rrc, Gll^Fp, Gg, Rr^Vhc, Rrc, Rrc, Ch, Chr, Ww, Wo, Wo^Bsb/, Rp, Ww, Rp, Ww, Ww, Wo, Wo, Wo, Wo, Wo, Ww, Gg, Gg, Gg, Gg, Gg, Rr, Rr, Rr, Gg, Gg, Gg, Co, Re^Vct, Gg, Gg, Gg
Wo, Wo, Wo, Wo, Wo, Wo, Wo, Wo, Wo, Wo, Wo, Wo, Wo, Wo, Wo, Wo, Wo^Bw/, Ww, Ds, Rrc, Rrc, Rrc, Rrc, Rrc, Gll^Fmf, Gg, Gll^Fp, Rrc, Rrc, Rrc, Rrc, Rrc, Rp^Dr, Rp^Dr, Ww^Bsb/, Wo^Bsb/, Wo, Wo, Wo, Ww, Wo, Wo, Wo, Wo, Wo, Wo, Ww, Ww, Gg, Gg, Gs, Gg, Gg, Rr, Rr, Rr, Gg, Gg, Gg, Gg, Gg, Gg, Gg, Gg
Wo, Wo, Wo, Wo, Wo, Wo, Wo, Wo, Wo, Wo, Wo, Wo, Wo, Wo, Wo, Wo, Ww, Ww^Bw\, Ds, Gg, Gg, Gg, Gg, Rrc, Gll^Fmw, Kha, Gll^Fmw, Rrc, Rrc, Rrc, Rr^Vhc, Rrc, Rrc, Rrc, Ww, Wo, Wo, Wo, Wo, Wo, Wo, Wo, Wo, Wo, Wo, Wo, Ww, Gg, Gg, Gg, Gs, Gg, Gg, Rr, Rr, Rr, Gg, Gg, Gg, Gg, Gg, Gg, Gg, Gg
Wo, Wo, Wo, Wo, Wo, Wo, Wo, Wo, Wo, Wo, Ce, Wo, Ch, Wo, Ww, Ww, Ch, Ds, Gg, Gg, Gll^Fmf, Gll^Fmf, Gg, Rrc, Rrc, Gg, Rrc, Rrc, Gg, Gg, Gg, Gg, Ch, Chr, Wo, Wo, Wo, Wo, Wo, Wo, Wo, Wo, Wo, Wo, Wo, Ww, Gg, Gg, Gll^Fmf, Gll^Fmf, Gs, Gll^Fmf, Gg, Rr, Rr, Rr, Gg, Gg, Gg, Gg, Gg, Gg, Gs, Gg
Wo, Wo, Wo, Wo, Wo, Wo, Wo, Wo, Wo, Wo, Wo, Ce, Wo, Ch, Ch, Ch, Ww, Ch, Gg, Gg, Gll^Fmf, Gll^Fdf, Gg, Rr^Vhc, Rrc, Rrc, Rrc, Gg, Gg, Gg, Gg, Ch, Ww, Ww, Wo, Wo, Wo, Wo, Wo, Wo, Wo, Wo, Wo, Wo, Ww, Ww, Gg, Gg, Gll^Fmf, Gll^Fmf, Gg, Gs, Gg, Rr, Rr, Rr, Gd^Vhr, Gg, Gg, Gg, Gs, Gg, Gs, Gg
Wo, Wo, Wo, Wo, Wo, Wo, Wo, Wo, Wo, Wo, Wo, Wo, Wo, Wo, Wo, Wo, Wo, Ww, Ww, Gg, Gg, Gg, Gg, Gg, Rrc, Rrc, Rrc, Rr^Vhc, Gg, Gg, Gg, Gg, Ww, Ww, Wo, Wo, Wo, Wo, Wo, Wo, Wo, Wo, Wo, Wo, Ww, Gg, Gg, Gg, Gs, Gg, Gg, Gg, Rr, Rr, Rr, Rr, Gg, Gg, Gg, Gs, Gs, Gg, Gg, Gg
Wo, Wo, Wo, Wo, Wo, Wo, Wo, Wo, Wo, Wo, Wo, Wo, Wo, Wo, Wo, Wo, Wo, Wo, Wo, Ww, Ww, Ch, Ch, Gg, Rrc, Chr, Rrc, Gg, Ch, Ch, Ww, Ww, Wo, Wo, Wo, Wo, Wo, Wo, Wo, Wo, Wo, Wo, Wo, Ww, Gg, Gg, Gg, Gg, Gg, Gs, Gg, Gg, Rr, Rr, Rr, Rr, Gg, Gg, Gg, Gs, Gg, Gg, Gg, Gg
Wo, Wo, Wo, Wo, Wo, Wo, Wo, Wo, Wo, Wo, Wo, Wo, Wo, Wo, Wo, Wo, Wo, Wo, Wo, Wo, Wo, Ww, Ww, Chr, Rrc, Chr, Rrc, Chr, Ww, Ww, Wo, Wo, Wo, Wo, Wo, Wo, Wo, Wo, Wo, Wo, Wo, Wo, Ww, Ww, Ww, Ww, Ww, Ww, Ww, Gs, Gg, Gg, Rr, Rr, Rr, Rr, Gg, Gg, Gg, Gg, Gg, Gg, Gg, Gg
Wo, Wo, Wo, Wo, Wo, Wo, Wo, Wo, Wo, Wo, Wo, Wo, Wo, Wo, Wo, Wo, Wo, Wo, Wo, Wo, Wo, Wo, Wo, Ww, Ww^Bsb|, Ww, Ww^Dr, Ww, Wo, Wo, Wo, Wo, Wo, Wo, Wo, Wo, Wo, Wo, Wo, Wo, Ww, Ww, Gg, Gg, Gg, Gg, Gg, Gg, Ww, Gs, Gg, Rr, Rr, Rr, Rr, Gg, Hh, Gg, Hh, Gg, Gg, Gg, Gg, Gg
Wo, Wo, Wo, Wo, Wo, Wo, Wo, Wo, Wo, Wo, Wo, Wo, Wo, Wo, Wo, Wo, Wo, Wo, Wo, Wo, Wo, Wo, Ww, Ww, Rp, Ww, Rp, Ww, Ww, Wo, Wo, Wo, Wo, Wo, Wo, Wo, Wo, Wo, Ww, Ww, Gg, Gg, Gll^Fmf, Gg, Gg, Gs, Gg, Gg, Wwr, Gg, Rr, Rr, Rr, Rr, Gg, Gg, Hh, Hh, Gg, Hh, Gs, Gs, Gg, Gg
Wo, Wo, Wo, Wo, Wo, Wo, Wo, Wo, Ww, Wo, Wo, Wo, Wo, Wo, Wo, Wo, Wo, Wo, Wo, Wo, Wo, Wo, Ww, Ch, Chr^Dr, Rp, Rp^Dr, Chr, Ww, Wo, Wo, Wo, Wo, Wo, Wo, Wo, Ww, Ww, Gg, Gg, Gg, Gll^Fmf, Gll^Fmw, Gg, Gg, Gg, Gg, Wwr, Rr, Rr, Rr, Rr, Rr, Rr, Gg, Gg, Hh, Gg, Gg, Gg, Gs, Gs, Gg, Gg
Wo, Wo, Wo, Wo, Wo, Wo, Wo, Ww, Wwr, Ww, Wo, Wo, Wo, Wo, Wo, Wo, Wwr, Wo, Wo, Wo, Wo, Wo, Wo, Ww, Ww, Rp, Ww, Ww, Wo, Wo, Wo, Wo, Wo, Wo, Ww, Ww, Ww, Ww, Gg, Gg, Gs, Gll^Fmw, Gll^Fmf, Gll^Fmf, Gg, Gg, Rr, Rr, Rr, Rr, Rr, Rr, Gg, Gg, Gg, Gg, Hh, Gg, Gg, Gs, Gs, Gg, Gg, Gg
Wo, Wo, Wo, Wo, Wo, Wo, Wo, Ww, Ww, Ww, Wo, Wo, Wo, Wo, Wo, Wwr, Wwr, Wo, Wo, Wo, Wo, Wo, Wo, Wo, Wo, Ww, Wo, Wo, Wo, Wo, Wo, Wo, Ww, Ww, Ww, Ww, Ww, Wwr, Gg, Gg, Gg, Gll^Fmw, Gll^Fmw, Gg, Gs, Gg, Rr, Rr, Rr, Rr, Rr, Gg, Gg, Gg, Gg, Gg, Gg, Gg, Gll^Fmf, Gll^Fmf, Gs, Gg, Gd, Gg
Wo, Wo, Wo, Wo, Wo, Wo, Wo, Wo, Wo, Wo, Wo, Wo, Wo, Wo, Wo, Wo, Wo, Wo, Wo, Wo, Wo, Wo, Wo, Wo, Wo, Wo^Dr, Wo, Wo, Ww, Ww, Ww, Ww, Gs, Gg, Gg, Wwr, Wwr, Wwr, Gg, Gg, Gg, Gg, Gg, Gg, Rr, Rr, Rr, Rr, Rr, Rr, Gg, Gg, Gg, Gg, Hh, Gg, Gg, Gg, Gs, Gs, Gg, Gg, Gg, Gd
Wo, Wo, Wo, Wo, Wo, Wo, Wo, Wo, Wo, Wo, Wo, Wo, Wo, Wo, Wo, Wo, Wo, Wo, Wo, Wo, Wo, Wo, Wo, Wo, Wo, Wo, Ww, Ww, Gs, Gg, Gg, Gg, Gg, Gg, Gg, Gg, Gg, Gg, Gg, Gg, Gg, Gg, Rr, Rr, Rr, Rr, Rr, Rr, Gd^Vhr, Gg, Gg, Gg, Gll^Fmf, Gg, Gg, Hh, Gg, Gg, Gg, Gg, Gg, Gg, Gg, Gg
Wo, Wo, Wo, Wo, Wo, Wo, Wo, Wo, Wo, Wo, Wo, Wo, Wo, Wo, Wo, Wo, Wo, Wo, Wo, Wo, Wo, Wo, Wo, Wo, Ww, Ww^Bsb|, Gg, Gg, Gg, Gg, Gs, Gg, Gg, Gg, Hh, Gg, Hh, Hh, Gg, Gg, Rr, Rr, Rr, Rr, Rr, Rr, Gg, Gg, Gg, Gg, Gg, Gg, Gg, Gg, Gg, Gg, Gg, Gs, Gs, Gg, Gg, Gg, Gs, Gg
Wo, Wo, Wo, Wo, Wo, Wo, Wo, Wo, Wo, Wo, Wo, Wo, Wo, Wo, Wo, Wo, Wo, Wo, Wo, Wo, Ww, Wo, Ww, Ww, Gg, Rr, Gg, Gg, Gg, Gg, Gg, Gs, Gs, Gg, Gg, Gg, Gg, Gg, Rr, Rr, Rr, Rr, Rr, Rr, Gg, Gg, Ce, Ce, Ce, Gg, Gg, Gg, Gg, Gg, Gg, Gg, Hh, Gg, Gs, Gg, Gg, Gg, Gs, Gg
Wo, Wo, Wo, Wo, Wo, Wo, Wo, Wo, Wo, Wo, Wo, Wo, Wo, Wo, Wo, Wo, Wo, Wo, Ww, Ww, Gg, Ww, Gs, Gs, Gg, Rr, Gg, Ce, Ce, Gg, Gg, Gs, Gs, Gg, Gg, Gg, Rr, Rr, Rr, Rr, Rr, Rr, Gg, Gg, Gg, Gg, Ce, Ket, Ce, Re^Vct, Gg, Gg, Gs, Gg, Gg, Gg, Gg, Gg, Gs, Gg, Gll^Fmf, Gg, Gg, Gg
Wo, Wo, Wo, Wo, Wo, Wo, Wo, Wo, Wo, Wo, Wo, Wo, Wo, Wo, Ww, Wo, Ww, Ww, Gg, Gg, Gg, Gg, Gg, Gg, Gg, Rr, Gg, Ce, Ce, Ce, Gg, Gg, Rr, Gg, Rr, Rr, Rr, Rr, Rr, Rr, Gg, Gg, Gg, Gg, Gg, Gg, Gg, Ce, Gg, Gg, Gg, Gg, Gg, Gg, Gll^Fmf, Gg, Gg, Gg, Gg, Gs, Gll^Fmf, Gg, Gg, Gg
Wo, Wo, Wo, Wo, Wo, Wo, Wo, Wo, Wo, Wo, Wo, Wo, Ww, Ww, Gg, Ww, Gg, Gg, Gg, Gg, Ce, Ce, Ce, Ce, Gg, Rr, Gg, Ke, Gg, Gg, Rr, Rr, Rr, Rr, Rr, Rr, Rr, Rr, Gg, Gg, Gg, Gg, Gg, Gg, Gg, Gg, Gg, Gg, Gg, Gg, Gs, Gg, Gg, Gll^Fmf, Gg, Gg, Gg, Gg, Gg, Gs, Gll^Fmf, Gg, Gg, Gg
Wo, Wo, Wo, Wo, Wo, Wo, Wo, Wo, Wo, Wo, Ww, Ww, Gg, Gg, Gg, Gg, Gg, Gg, Gg, Gg, Gg, Ke, Gg, Ce, Gg, Rr, Gd^Vhr, Gg, Rr, Rr, Rr, Rr, Rr, Rr, Rr, Rr, Gd^Vhr, Gg, Gg, Gg, Gg, Gg, Gd, Gg, Gg, Hh, Hh, Gg, Gg, Gg, Gg, Gg, Gg, Gll^Fmf, Gll^Fmw, Gll^Fmw, Gll^Fmw, Gll^Fmf, Gg, Gll^Fmf, Gs, Gg, Gg, Gg
Wo, Wo, Wo, Wo, Wo, Wo, Wo, Wo, Ww, Ww, Gg, Gg, Gll^Fmf, Gg, Gg, Gg, Gg, Gg, Gg, Gg, Gll^Fmf, Gg, Gg, Gg, Gg, Rr, Rr, Rr, Rr, Rr, Rr, Rr, Rr, Rr, Ce, Gg, Gg, Gg, Gg, Gg, Gg, Gd, Gg, Gg, Gs, Gg, Gg, Hh, Gg, Gg, Gg, Gg, Gg, Gll^Fmf, Gll^Fmf, Gll^Fmf, Gg, Gg, Gg, Gll^Fmf, Gll^Fmf, Gll^Fmw, Gg, Gg
Wo, Wo, Wo, Wo, Wo, Wo, Ww, Ww, Gg, Gg, Gg, Gg, Gg, Gll^Fmf, Gll^Fmf, Gg, Gg, Gg, Gg, Gs^Vl, Gll^Fmf, Gll^Fmf, Gg, Gg, Rr, Rr, Rr, Rr, Rr, Rr, Gg, Rr, Gg, Gg, Ke, Ce, Ce, Ce, Gg, Gg, Gg, Gg, Gg, Gg, Gg, Gs, Gs, Gs, Gg, Gg, Gg, Gg, Gg, Gg, Gg, Gg, Gg, Gg, Gll^Fmw, Gll^Fmw, Gll^Fmw, Gll^Fmw, Gg, Gg
Wo, Wo, Wo, Wo, Wo, Wo, Ww, Gg, Gg, Gg, Gg, Gg, Gg, Gg, Gg, Gg, Gg, Gg, Gg, Gg, Gg, Gg, Rr, Rr, Rr, Rr, Rr, Rr, Gg, Gg, Gg, Gg, Gg, Gg, Gg, Ce, Gg, Gg, Gg, Gg, Gg, Gg, Gg, Gg, Gg, Gg, Gg, Gg, Gg, Gg, Gg, Gg, Gd, Gd, Gg, Gg, Gg, Gll^Fmf, Gg, Gll^Fmf, Gg, Gg, Gg, Gg
Wo, Wo, Wo, Wo, Wo, Wo, Ww, Gg, Gg, Gg, Gg, Gg, Gg, Gll^Fmf, Gg, Gg, Wo, Gg, Gg, Gg, Gg, Rr, Rr, Rr, Rr, Rr, Gg, Gg, Gg, Gg, Gg, Gg, Gg, Gg, Gg, Gg, Gg, Gg, Gg, Gg, Gg, Gg, Gg, Gg, Gg, Gg, Gg, Gg, Gg, Gg, Gg, Gg, Gg, Gg, Gg, Gg, Gg, Gg, Gg, Gg, Gg, Gg, Gg, Gg
