Cv, Cv, Cv, Cv, Aa, Gg, Gg, Gg, Gg, Cv, Cv, Cv, Cv
Cv, Aa^Feta, Ai, Ai, Aa^Feta, Gg, Aa, Gg, Gg^Fet, Aa, Aa, Gg^Fet, Cv
Cv, Aa, Gg^Fet, Aa, Gg, Gg, Gg, Aa, Gg, Aa, Aa^Feta, Ww, Cv
Aa, Aa, Gg, Gg, Gg, Gg, Aa, Gg, Gg, Gg, Gg, Aa, Gg
Aa, Gg, Aa, Gg, Aa, Gg, Gg, Gg, Aa, Gg, Gg, Gg, Aa
Gg, Gg, Gg, Gg, Gg, Aa, Gg, Gg, Gg, Gg, Gg, Aa, Aa
Cv, Aa, Aa^Feta, Gg, Gg, Gg, Aa, Gg, Gg, Aa, Gg^Fet, Gg, Cv
Cv, Ai, Ww, Gg, Gg, Aa, Gg, Gg, Aa, Gg, Aa, Ww, Cv
Cv, Gg^Fet, Aa, Gg, Aa^Feta, Gg, Gg, Gg, Aa^Feta, Gg, Ai, Aa^Feta, Cv
Cv, Cv, Cv, Cv, Gg, Gg, Gg, Aa, Gg, Cv, Cv, Cv, Cv
