Gll^Fp, Gll^Fp, Gll^Fp, Gg, Gll^Fp, Ww, Wo, Wo, Wo, Wo, Wo, Wo, Wo, Wo, Ww, Wo, Cva, Gg, Gg, Gg, Gg, Gg, Cva, Wo, Ww, Wo, Wo, Wo, Wo, Wo, Wo, Wo, Wo, Ai, Gll^Fp, Gg, Gg, Gg, Aa^Fpa
Gg, Gll^Fp, Aa^Fpa, Gll^Fp, Ww, Ww, Wo, Wo, Ai, Wo, Ai, Wo, Ww, Ww, Cv, Cva, Gg, Gg, Gg, Gg, Gg, Gg, Gg, Cva, Cv, Ww, Ww, Wo, Wo, Ai, Wo, Wo, Wo, Ai, Gll^Fp, Aa, Gll^Fp, Aa^Fpa, Gg
Gg, Gll^Fp, Gll^Fp, Ai, Wo, Wo, Wwr, Wo, Wo, Ai, Ww, Ww, Cv, Cv, Gg, Gg, Gg, Gg, Gg, Aa, Aa, Gg, Gg, Gg, Gg, Cv, Cva, Ww, Ww, Wo, Wo, Wo, Wo, Ai, Ai, Aa^Fpa, Gll^Fp, Aa^Fpa, Gll^Fp
Aa^Fpa, Aa^Fpa, Ai, Ww, Wo, Wo, Ai, Wo, Wo, Wo, Ww, Cva, Gg, Gg, Gg, Aa, Gg, Gg, Gg, Gg, Gg, Gg, Aa, Gg, Gg, Gg, Gg, Cva, Ww, Wo, Wo, Wo, Ai, Wo, Wo, Ai, Ai, Gll^Fp, Gll^Fp
Aa^Fpa, Aa, Ai, Wo, Wo, Wo, Ai, Wo, Wo, Ww, Cv, Cva, Gg, Gg, Gg, Gg, Gg, Gg, Gg, Gg, Aa, Gg, Gg, Aa, Gg, Gg, Gg, Cv, Cv, Ww, Wo, Wo, Wo, Wo, Wo, Wo, Ai, Aa^Fpa, Aa^Fpa
Gg, Gll^Fp, Ww, Wo, Wo, Wo, Wo, Wo, Wo, Ww, Cv, Gg, Gg, Gg, Gg, Aa, Gg, Gg, Aa, Aa, Aa, Aa, Gg, Gg, Gg, Gg, Aa, Gg, Cv, Ww, Wo, Wo, Wo, Wwr, Ww, Wo, Wo, Ai, Ai
Wwr, Wwr, Ai, Wo, Wo, Wo, Wo, Wo, Ww, Ww, Cv, Gg, Gg, Gg, Aa, Aa, Gg, Gg, Gg, Gg, Gg, Gg, Gg, Gg, Gg, Gg, Aa, Gg, Cva, Ww, Ww, Wo, Wo, Ww, Wo, Wo, Wo, Wo, Wo
Wwr, Wwr, Wo, Wo, Ai, Wo, Wo, Wo, Ww, Cva, Gg, Gg, Aa, Aa, Aa, Aa, Gg, Gg, Cv, Gg, Cva, Gg, Aa, Aa, Aa, Gg, Aa, Gg, Gg, Cva, Ww, Wo, Ai, Wo, Wo, Aa, Wo, Wo, Wo
Wo, Wo, Wo, Wo, Aa, Wo, Wo, Wo, Ww, Cva, Gg, Gg, Gg, Aa, Aa, Aa, Gg, Cv, Gg, Kva, Gg, Cva, Gg, Aa, Aa, Gg, Aa, Gg, Gg, Cva, Ww, Wo, Wo, Wo, Wo, Ai, Ww, Wo, Wo
Wo, Wo, Wo, Ai, Wo, Wo, Wo, Wo, Ww, Cva, Gg, Gg, Gg, Aa, Gg, Gg, Gg, Cva, Ds, Gg, Aa, Cv, Gg, Gg, Aa, Aa, Aa, Gg, Gg, Cv, Ww, Wo, Wo, Wo, Wo, Wo, Ww, Ww, Wo
Wo, Wo, Wo, Wo, Wo, Wo, Wo, Ww, Cv, Cv, Gg, Gg, Gg, Gg, Aa, Gg, Gg, Ds, Ai, Aa^Feta, Ww, Aa, Gg, Gg, Aa, Aa, Aa, Aa, Gg, Cv, Cv, Ww, Wo, Ai, Wo, Wo, Wo, Wo, Wo
Wo, Wo, Wo, Wwr, Wo, Wo, Ww, Ww, Cv, Gg, Gg, Gg, Aa, Aa, Gg, Gg, Gg, Ds, Aa, Ww^Ewf, Ds, Ds, Gg, Gg, Gg, Aa, Aa, Gg, Aa, Gg, Cv, Ww, Ww, Wo, Ai, Aa, Wo, Ai, Wo
Wo, Wo, Wo, Wo, Ww, Ww, Cva, Cv, Gg, Gg, Gg, Gg, Aa, Gg, Gg, Gg, Gg, Gg, Gg, Aa, Gg, Gg, Aa, Gg, Gg, Gg, Aa, Gg, Gg, Gg, Aa^Fpa, Cv, Cva, Ww, Ww, Wo, Wo, Wo, Wo
Wo, Wo, Ww, Ww, Cv, Cva, Gg, Gg, Gg, Gg, Aa^Fpa, Aa, Gg, Gg, Aa, Aa, Aa, Gg, Gg, Gg, Aa, Aa, Aa, Aa, Gg, Gg, Gg, Aa, Aa, Gg, Gll^Fp, Gg, Gg, Cva, Cva, Ww, Ww, Wo, Wo
Wo, Ww, Cva, Cv, Gg, Gg, Gg, Gg, Gg, Aa, Gg, Aa^Fpa, Gll^Fp, Gg, Aa, Gg, Gg, Aa, Aa, Aa, Aa, Aa, Gg, Gg, Aa, Gg, Aa^Fpa, Aa, Aa, Aa, Gll^Fp, Gg, Gg, Gg, Gg, Cv, Cva, Ww, Wo
Wo, Ww, Cva, Gg, Gll^Fp, Gg, Aa^Fpa, Gg, Aa, Gg, Gg, Gll^Fp, Aa^Fpa, Gg, Gg, Gg, Gg, Gg, Aa, Aa, Gg, Gg, Gg, Gg, Aa, Aa, Aa^Fpa, Aa^Fpa, Aa, Aa^Fpa, Aa, Gll^Fp, Aa, Aa, Gll^Fp, Gll^Fp, Cv, Ww, Wo
Wo, Ww, Cv, Gg, Aa^Fpa, Gg, Aa, Aa^Fpa, Gll^Fp, Aa, Aa, Gg, Gg, Aa^Fpa, Gg, Gg, Gg, Aa, Gg, Aa, Aa, Gg, Gg, Gg, Gg, Gg, Gll^Fp, Gll^Fp, Aa, Aa, Aa^Feta, Aa, Aa^Fpa, Aa, Gg, Gll^Fp, Cv, Ww, Wo
Ww, Ww, Cv, Gg, Aa, Aa, Gg, Gg^Fet, Aa^Fpa, Aa^Fpa, Gg, Aa, Gg, Aa^Fpa, Gg, Cva, Gg, Gg, Aa, Gg, Gg, Gg, Gg, Cv, Gg, Gg, Gg, Aa^Fpa, Aa, Aa, Gll^Fp, Aa^Fpa, Aa, Aa^Fpa, Gg, Gg, Cva, Ww, Ww
Ww, Cv, Gg, Gg, Gg, Aa, Aa^Fpa, Aa^Fpa, Aa^Fpa, Gll^Fp, Aa^Fpa, Aa, Aa^Fpa, Gg, Gg, Cva, Gg, Gg, Aa, Gg, Gg, Gg, Gg, Cva, Gg, Aa, Gg, Aa^Fpa, Gg, Aa, Gg, Gg, Gg, Aa, Gg, Gg, Aa^Fpa, Cva, Ww
Ww, Cva, Gg, Gg, Gg, Aa^Fpa, Gg, Gll^Fp, Gll^Fp, Aa^Fpa, Aa, Aa, Gg, Aa^Fpa, Gg, Cva, Gg, Aa, Aa, Gg, Aa, Gg, Gg, Cv, Gg, Gg, Gg, Aa^Fpa, Gg, Gg, Aa, Aa, Gg, Aa, Gg, Gll^Fp, Aa^Fpa, Cv, Ww
Ww, Cv, Cva, Gg, Cv, Gg, Gg, Gg, Gg, Gg, Gg, Gg, Cva, Cv, Cv, Cva, Cva, Gg, Gg, Gg, Gg, Gg, Cva, Cv, Cv, Cv, Cva, Gg, Gg, Gll^Fp, Gg, Aa, Gg, Gg, Cva, Gg, Cv, Cv, Ww
Wo^_fme, Ww, Ww, Cv, Ww, Cv, Cva, Cv, Cv, Cv, Cv, Cv, Ww, Ww, Ww, Ww, Cva, Gg, Gg, Gg, Gg, Gg, Cva, Ww, Ww, Ww, Ww, Cva, Cva, Gg, Cv, Gg, Cva, Cv, Ww, Cva, Ww, Ww, Wo
Wo, Wo^_fme, Wo, Ww, Wo, Ww, Ww, Ww, Ww, Ww, Ww, Ww, Wo, Wo, Wo, Ww, Cva, Gg, Gg, Gg, Gg, Gg, Cva, Ww, Wo, Wo, Wo, Ww, Ww, Cv, Ww, Cv, Ww, Ww, Wo, Ww, Wo, Wo, Wo
