Ms^Xm, Mm^Xm, Ms^Xm, Ms^Xm, Ms^Xm, Mm^Xm, Mm^Xm, Mm^Xm, Mm^Xm, Mm^Xm, Mm^Xm, Mm^Xm, Mm^Xm, Mm^Xm, Mm^Xm, Xu, Xos, Xos, Xos, Xos, Urb, Urb, Urb, Xos, Xos, Xos, Xos, Xu, Ms^Xm, Mm^Xm, Mm^Xm, Mm^Xm, Mm^Xm, Mm^Xm, Ms^Xm, Mm^Xm, Mm^Xm, Mm^Xm, Mm^Xm, Mm^Xm, Mm^Xm, Mm^Xm, Mm^Xm, Mm^Xm, Mm^Xm, Ms^Xm
Ms^Xm, Ms^Xm, Mm^Xm, Ms^Xm, Ms^Xm, Mm^Xm, Mm^Xm, Mm^Xm, Mm^Xm, Mm^Xm, Mm^Xm, Mm^Xm, Ms^Xm, Mm^Xm, Mm^Xm, Xu, Xos, Xos, Xos, Xos, Urb, Urb, Urb, Xos, Xos, Xos, Xos, Xu, Ms^Xm, Ms^Xm, Ms^Xm, Mm^Xm, Mm^Xm, Mm^Xm, Mm^Xm, Mm^Xm, Mm^Xm, Mm^Xm, Mm^Xm, Mm^Xm, Ms^Xm, Ms^Xm, Ms^Xm, Mm^Xm, Ms^Xm, Ms^Xm
Ms^Xm, Ms^Xm, Mm^Xm, Mm^Xm, Ms^Xm, Ms^Xm, Ms^Xm, Mm^Xm, Ms^Xm, Mm^Xm, Ms^Xm, Ms^Xm, Mm^Xm, Mm^Xm, Mm^Xm, Xu, Xos, Xos, Xos, Xos, Urb, Urb, Urb, Xos, Xos, Xos, Xos, Xu, Ms^Xm, Ms^Xm, Ms^Xm, Ms^Xm, Ms^Xm, Ms^Xm, Ms^Xm, Ms^Xm, Ms^Xm, Ms^Xm, Ms^Xm, Ms^Xm, Ms^Xm, Ms^Xm, Mm^Xm, Mm^Xm, Mm^Xm, Ms^Xm
Ms^Xm, Mm^Xm, Mm^Xm, Ms^Xm, Ms^Xm, Ms^Xm, Ms^Xm, Ms^Xm, Ms^Xm, Ms^Xm, Mm^Xm, Ms^Xm, Ms^Xm, Mm^Xm, Mm^Xm, Xu, Xos, Xos, Urb, Urb, Urb, Urb, Urb, Urb, Urb, Xos, Xos, Xu, Ms^Xm, Mm^Xm, Mm^Xm, Ms^Xm, Ms^Xm, Ms^Xm, Ms^Xm, Ms^Xm, Mm^Xm, Ms^Xm, Mm^Xm, Mm^Xm, Ms^Xm, Ms^Xm, Mm^Xm, Mm^Xm, Mm^Xm, Ms^Xm
Ms^Xm, Mm^Xm, Mm^Xm, Mm^Xm, Ms^Xm, Ms^Xm, Ms^Xm, Ms^Xm, Mm^Xm, Mm^Xm, Mm^Xm, Mm^Xm, Ms^Xm, Mm^Xm, Mm^Xm, Xu, Xos, Uu^Vud, Urb, Urb, Cud, Cud, Cud, Urb, Urb, Uu^Vud, Xos, Xu, Ms^Xm, Ms^Xm, Ms^Xm, Mm^Xm, Mm^Xm, Ms^Xm, Ms^Xm, Mm^Xm, Mm^Xm, Mm^Xm, Ms^Xm, Ms^Xm, Mm^Xm, Ms^Xm, Ms^Xm, Mm^Xm, Mm^Xm, Ms^Xm
Ms^Xm, Ms^Xm, Ms^Xm, Ms^Xm, Ms^Xm, Ms^Xm, Ms^Xm, Ms^Xm, Ms^Xm, Mm^Xm, Ms^Xm, Mm^Xm, Ms^Xm, Mm^Xm, Mm^Xm, Xu, Xos, Urb, Urb, Urb, Cud, Kud, Cud, Urb, Urb, Urb, Xos, Xu, Ms^Xm, Mm^Xm, Ms^Xm, Mm^Xm, Mm^Xm, Ms^Xm, Ms^Xm, Ms^Xm, Ms^Xm, Ms^Xm, Mm^Xm, Mm^Xm, Mm^Xm, Ms^Xm, Mm^Xm, Mm^Xm, Ms^Xm, Ms^Xm
Ms^Xm, Ms^Xm, Mm^Xm, Mm^Xm, Ms^Xm, Mm^Xm, Mm^Xm, Ms^Xm, Mm^Xm, Ms^Xm, Mm^Xm, Ms^Xm, Ms^Xm, Mm^Xm, Mm^Xm, Xu, Xos, Uu^Vud, Urb, Urb, Urb, Cud, Urb, Urb, Urb, Uu^Vud, Xos, Xu, Ms^Xm, Mm^Xm, Mm^Xm, Ms^Xm, Ms^Xm, Ms^Xm, Ms^Xm, Ms^Xm, Mm^Xm, Ms^Xm, Ms^Xm, Ms^Xm, Ms^Xm, Ms^Xm, Mm^Xm, Mm^Xm, Ms^Xm, Ms^Xm
Ms^Xm, Ms^Xm, Ms^Xm, Ms^Xm, Ms^Xm, Ms^Xm, Ms^Xm, Ms^Xm, Ms^Xm, Mm^Xm, Mm^Xm, Ms^Xm, Ms^Xm, Mm^Xm, Ms^Xm, Xu, Xu, Xos, Xos, Urb, Urb, Urb, Urb, Urb, Xos, Xos, Xu, Xu, Mm^Xm, Mm^Xm, Mm^Xm, Mm^Xm, Mm^Xm, Mm^Xm, Ms^Xm, Ms^Xm, Ms^Xm, Mm^Xm, Mm^Xm, Mm^Xm, Ms^Xm, Ms^Xm, Ms^Xm, Ms^Xm, Ms^Xm, Ms^Xm
Mm^Xm, Ms^Xm, Ms^Xm, Ms^Xm, Ms^Xm, Ms^Xm, Ms^Xm, Ms^Xm, Ms^Xm, Mm^Xm, Ms, Ms^Xm, Mm, Ms^Xm, Ms, Ms^Xm, Ms^Xm, Xu, Xu, Xos, Xos, Urb, Xos, Xos, Xu, Xu, Ms^Xm, Ms^Xm, Ms, Mm, Ms, Mm^Xm, Mm, Mm^Xm, Mm, Ms^Xm, Ms^Xm, Ms, Ms, Ms, Mm^Xm, Mm^Xm, Mm^Xm, Ms^Xm, Ms^Xm, Ms^Xm
Mm^Xm, Mm^Xm, Ms, Ms^Xm, Mm^Xm, Ms^Xm, Mm, Ms^Xm, Mm, Mm, Mm, Mm, Mm, Mm, Mm, Ms^Xm, Ms^Xm, Ms^Xm, Ms^Xm, Xu, Xu, Urb, Xu, Xu, Ms^Xm, Ms^Xm, Ms^Xm, Ms^Xm, Ms, Ms, Mm, Mm, Mm, Mm, Mm, Ms, Ms, Ms, Mm, Mm, Mm, Ms, Ms^Xm, Ms^Xm, Ms^Xm, Ms^Xm
Mm, Ms, Ms, Ms, Mm, Mm, Mm, Mm, Mm, Mm, Mm, Mm, Mm, Mm, Mm, Ms, Ms^Xm, Ms^Xm, Ms^Xm, Ms^Xm, Ms^Xm, Urb, Rra, Ms^Xm, Ms^Xm, Ms^Xm, Ms^Xm, Ms^Xm, Ms, Mm, Ms, Mm, Mm, Mm, Mm, Ms, Mm, Ms, Mm, Mm, Mm, Mm, Mm, Ms, Mm^Xm, Ms^Xm
Ms, Ms, Ms, Mm, Mm, Mm, Mm, Ms, Mm, Mm, Mm, Mm, Mm, Mm, Ms, Ms, Ms^Xm, Ms^Xm, Ms^Xm, Ms, Cha, Cha, Cha, Rra, Ms^Xm, Ms^Xm, Ms^Xm, Ms, Mm, Ms, Mm, Ms, Ms, Ms, Mm, Mm, Mm, Mm, Mm, Ms, Mm, Ms, Mm, Mm, Ms, Mm^Xm
Ms, Ms, Mm, Ms, Mm, Mm, Gg, Ms, Gg, Ms, Ms, Mm, Gg, Mm, Gg, Ms^Xm, Mm^Xm, Ms^Xm, Mm, Ha, Cha, Kha, Cha, Rra, Rra, Ms^Xm, Ms^Xm, Ms, Ha, Mm, Gg, Ms, Ms, Ms, Mm, Ms, Ms, Mm, Mm, Mm, Mm, Mm, Mm, Mm, Ms, Mm
Mm, Ms, Ha, Gg, Gg, Gg, Aa, Gg, Gg, Ha, Aa^Fpa, Ha, Gg, Gg, Gg, Gg, Ch, Mm^Xm, Mm, Ch, Rra, Ch, Rra, Ch, Rra, Ha, Ch, Ha, Ha, Gg, Gg, Gg, Gg, Gg, Aa^Fpa, Ms, Aa^Fpa, Mm, Ha, Ms, Ms, Ms, Mm, Mm, Mm, Mm
Gg, Ha, Gg, Gg, Gs, Gg, Gs, Aa, Gs, Gs, Gs, Gs, Gs, Gg, Ch, Ch, Gg, Ch, Ch, Rra, Ch, Ch, Ch, Rra, Ch, Ch, Gs^Vh, Ch, Ch, Gg, Gs, Aa, Aa, Aa, Gg, Aa^Fpa, Gg, Gg, Gg, Ha, Ms, Mm, Mm, Mm, Mm, Mm
Gg, Gg, Gg, Gs, Gs, Gs, Gg, Gs, Gs, Aa, Aa, Gs, Gg, Gg, Ch, Rr^Vhc, Gg, Ww, Ds, Rra, Rrc, Ch, Rrc, Rra, Hh, Aa, Gg, Aa, Ch, Gg, Gs, Gg, Gg, Gg, Gg, Gg, Gg, Gg, Gg, Ha, Gg, Gg, Gg, Mm, Ms, Ms
Gg, Gg, Aa^Fda, Gg, Aa^Fpa, Gg, Gg, Gg, Gg, Aa, Gs, Gs^Dr, Gg, Gg, Ch, Gg, Gs^Vh, Ww, Ww, Ds, Gg, Rrc, Gg, Gg, Hh, Gll^Fmw, Gll^Fp, Rr^Vhc, Ch, Gg, Gs, Gs^Dr, Gg, Gg, Gg, Gg, Gg, Gg, Gll^Fmw, Gg, Gg, Aa, Aa, Gg, Mm, Mm
Gg, Aa^Fda, Gg, Aa^Fda, Aa^Fpa, Gg, Gll^Fmw, Gll^Fmw, Gll^Fmw, Gg, Gll^Fmw, Gll^Fmw, Gg, Gg, Ch, Gg, Gg, Ds, Ds, Ds, Gg, Rrc, Gg, Aa, Gll^Fmf, Aa^Fpa, Gll^Fmf, Gg, Ch, Gs, Gs, Gs, Gg, Gg, Gll^Fdw, Gll^Fmw, Gll^Fdw, Gll^Fmw, Gll^Fmw, Gg, Gg, Gg, Gg, Gg, Gg, Mm
Gg, Aa^Fda, Aa, Gg, Aa, Gg, Gg, Gll^Fmw, Mm, Gg, Hh, Gll^Fmw, Gg, Gg, Ch, Aa, Aa, Gg, Gg, Rr^Vhc, Gg, Rrc, Aa, Rr^Vhc, Gg, Gll^Fmf, Hh^Vhh, Aa, Ch, Gs, Gs, Gs, Aa, Gll^Fdw, Ce, Gll^Fdw, Gll^Fmw, Gll^Fdw, Gg, Gg, Gg, Gg, Aa, Gg, Gg, Gg
Gg, Gg, Gg, Aa^Fpa, Aa^Fpa, Gg, Hh, Mm, Mm, Mm, Ce, Ce, Gg^Dr, Gg, Gg, Ch, Ch, Gs^Vh, Ch, Gg, Gg, Rrc, Gg, Gg, Ch, Gg, Ch, Ch, Gs, Gs, Rb^Gvs, Gs, Ce, Aa, Ce, Ce, Ce, Gg, Gg, Aa, Gg, Aa, Gg, Gg, Gg, Gg
Gg, Gg, Gg, Gg, Gg, Gg, Gg, Hh, Hh, Hh, Ce, Ce, Ce, Gs, Gs, Gg, Gg, Ch, Gg, Ch, Ch, Rrc, Ch, Ch, Gs, Ch, Gs, Gs, Gs^Gvs, Rb^Gvs, Rb^Gvs, Gs, Gg^Dr, Ce, Ke, Ce, Gg, Gg, Gg, Aa, Gg, Gg, Gg, Gg, Gg, Gg
Gg, Gs, Gs, Gg, Gg, Gg, Gg, Gg, Gs, Ce, Ce, Ke, Ce, Gs, Gs^Gvs, Gg^Gvs, Gs, Gg, Gs, Gg, Gg, Rrc, Gs, Gs, Gs^Dr, Gs, Rd^Gvs, Rd^Gvs, Rd^Gvs, Aa, Gs, Gs, Aa, Ce, Ce, Ce, Hh, Hh, Mm, Gg, Gg, Aa, Gg, Aa, Aa, Gg
Gg, Gg, Gg, Gs, Gs, Gs, Gs, Gs, Gll^Fmw, Ce, Gll^Fmw, Ce, Gll^Fmw, Gg, Gs, Gs, Aa, Gs, Gs^Gvs, Gs, Gg, Rrc, Gs, Gs, Gg, Gs, Aa, Aa, Aa, Aa, Gs, Gs, Aa, Gs, Hh, Hh, Mm, Mm, Mm, Mm, Gll^Fp, Gg, Gg, Gg, Gg, Gg
Gg, Gg, Gg, Gg, Gg, Gg, Gll^Fmw, Gg, Gg, Gll^Fmw, Gg, Gll^Fmw, Gg, Gg, Gs, Aa, Aa, Aa, Gs, Gg, Rrc, Rrc, Gs, Gs, Ce, Aa, Aa, Aa, Aa, Gs, Gg, Aa, Gs, Gs, Gg, Mm, Mm, Mm, Gll^Fmw, Gll^Fmw, Gll^Fp, Gg, Gg, Gg, Aa, Gg
Gg, Gg, Aa, Aa, Gg, Gll^Fmw, Gll^Fmw, Gg, Gg, Gg, Hh, Hh, Hh, Gd^Vhr, Gs, Ce, Ce, Ce, Gs^Dr, Gg, Rrc, Gg, Aa, Ce, Ce, Cea, Cea, Cea, Cea, Gs, Gs, Gs, Gs, Gll^Fmw, Gll^Fmw, Gll^Fmw, Gll^Fmw, Gll^Fp, Gll^Fp, Gll^Fp, Gg, Gg, Gg, Gg, Gs, Gg
Gg, Aa, Aa, Aa, Gg, Gll^Fmw, Gll^Fmw, Gll^Fmw, Gg, Gg, Hh, Hh, Hh, Hh, Ce, Ce, Ce, Ce, Ce, Gg, Rrc, Gg, Gg, Aa, Ce, Ce, Ket, Ce, Ce, Gs, Gs, Gd^Vhr, Gs, Gg, Gs, Gg, Gg, Gll^Fmw, Gg, Gg, Gg, Gg, Gg, Gg, Gs, Gs
Mm, Gg, Ms, Gg, Gg, Gg, Gg, Gll^Fmw, Gg, Gg, Gll^Fmw, Hh, Gg, Gg, Gg, Ce, Ket, Ce, Gg, Gg, Gg, Rrc, Gg, Gg, Gg, Ce, Ce, Ce, Gs, Gs, Gs, Gs, Aa, Gs, Aa, Gs, Gs, Gs, Gs, Gg, Mm, Ms, Ms, Mm, Mm, Mm
Mm, Ms, Ms, Ms, Gs, Gg, Gd, Gg, Gg, Gll^Fmw, Gll^Fmw, Gg, Gll^Fmw, Gg, Gd^Vhr, Ce, Ce, Ce, Aa, Gs, Gs, Rr, Gg, Gd^Vhr, Hh, Hh, Hh, Hh, Gs, Gs, Gs, Gs, Gs, Aa, Gs, Gs, Gs, Gs, Mm, Mm, Mm, Mm, Mm, Mm, Mm, Mm
Mm, Mm, Mm, Gg, Gs, Gs, Aa, Gs, Gs, Gs, Gs, Gs, Gs, Gg, Hh, Hh, Hh, Gs, Aa, Aa, Aa, Rr, Rr, Gg, Hh, Hh, Hh, Hh, Gs, Gs, Gg, Gs, Gg, Gs, Ms, Gg, Mm, Mm, Mm, Mm, Mm, Mm, Gg, Mm, Mm, Mm
Gg, Mm, Mm, Mm, Mm, Gs, Gs, Aa, Gs, Gg, Gg, Gs, Gs, Gg, Hh, Hh, Hh, Gs, Gs, Aa, Gg, Gg, Rr, Gg, Gg, Hh, Gg, Hh, Hh, Hh, Gg, Gg, Mm, Ms, Ms, Ms, Mm, Mm, Mm, Mm, Hh, Hh, Hh, Gg, Gs, Gg
Gg, Gg, Hh, Mm, Mm, Mm, Mm, Gs, Gs, Gs, Gs, Gs, Gs, Hh, Gs, Hh, Gs, Gs, Gg, Gg, Gg, Gg, Rrc, Gg, Gd, Gg, Gg, Gg, Hhd^Vhhr, Gg, Mm, Mm, Mm, Mm, Mm, Mm, Mm, Mm, Hh, Hh, Hh, Hh, Gs, Gs, Gs, Gg
Gg, Gg, Hh, Hh, Hh, Mm, Ms, Ms, Mm, Mm, Hhd^Vhhr, Gg, Mm, Gs, Gs, Gs, Gd, Gg, Gg, Gg, Rrc, Rrc, Hhd^Vhhr, Rrc, Gg, Gd, Gg, Gg, Mm, Mm, Mm, Mm, Mm, Mm, Mm, Mm, Gs, Hh, Gg, Hh, Gs, Gs, Gs, Aa, Aa, Gg
Gg, Gg, Gs, Hh, Hh, Hh, Hh, Mm, Mm, Mm, Mm, Ms, Mm, Mm, Mm, Gg, Gg, Gg, Rrc, Rrc, Mm, Mm, Mm, Rrc, Rrc, Gg, Gg, Mm, Mm, Mm, Gs, Mm, Gs, Mm, Gs, Gs, Gg, Hh, Gg, Gg, Gg, Gs, Gs, Gs, Gg, Aa
Gs, Gs, Aa^Fma, Gg, Gs, Hh, Hh, Hh, Hh, Mm, Ms, Mm, Hh, Hh, Hh, Gg, Rrc, Rrc, Mm, Mm, Mm, Mm, Mm, Mm, Rrc, Mm, Gg, Gg, Hh, Hh, Hh, Hh, Hh, Hh, Hh, Hh, Gg, Gg, Gs, Gs, Gll^Fdw, Gll^Fdw, Aa^Fda, Gll^Fp, Gs, Gg
Gll^Fp, Gs, Gg, Gs, Gg, Gs, Gs, Hh, Gg, Hh, Gg, Hh, Mm, Mm, Mm, Gg, Rr, Mm, Aa, Aa, Gg, Mm, Mm, Mm, Mm, Rrc, Rrc, Gg, Gg, Gs, Gg, Gg, Gg, Gg, Gg, Gg, Aa^Fma, Gg, Gg, Gs, Gll^Fp, Aa^Fda, Gll^Fdw, Gll^Fdw, Gs, Gs
Gg, Gg, Gll^Fp, Gg, Gg, Gg, Gg, Gg, Gg, Gg, Gg, Mm, Mm, Mm, Gg, Gg, Aa, Gg, Gg, Gg, Gg, Gg, Gg, Gg, Gll^Fmw, Gg, Gg, Rr, Rr, Gg, Gg, Gg, Aa, Aa, Gg, Gd, Gg, Gg, Gg, Gg, Gg, Gll^Fp, Gg, Gll^Fdw, Gg, Gs
Gg, Gll^Fmw, Gg, Gg, Gll^Fmw, Gll^Fp, Gll^Fmw, Gs, Gs, Gg, Gg, Gg, Gg, Gg, Gg, Gg, Rr, Gg, Gg, Gd, Gd, Gg, Gg, Gg, Gg, Gll^Fmw, Gg, Gg, Gg, Rr, Rr, Gg, Gg, Gg, Gg, Gg, Gg, Gg, Gd, Gg, Gd, Gg, Gg, Gg, Gg, Gg
Gll^Fmw, Gll^Fmw, Gg, Gll^Fp, Gll^Fp, Gg, Gll^Fp, Gg, Gg, Gll^Fmw, Gg, Gg, Gll^Fmw, Gg, Gg, Gg, Rr, Gg, Gg, Gg, Gg, Gg, Gg, Gll^Fmw, Gg, Gg, Gg, Gll^Fmw, Gg, Gg, Gd, Rr, Rrc, Rrc, Rr, Gg, Rr, Gd, Rrc, Gd, Gg, Gg, Gg, Gg, Ss, Gg
Gll^Fmw, Gll^Fp, Gll^Fmw, Gll^Fp, Gll^Fp, Gll^Fp, Gg, Gll^Fmw, Gll^Fmw, Gg, Gd, Gg, Gg, Gll^Fmw, Gg, Gg, Rr, Gg, Gg, Gg, Gll^Fmw, Gg, Gg, Gg, Gll, Gll, Gg, Gg, Gg, Gg, Gs, Gd, Gg, Gg, Gg, Rr, Gg, Rrc, Gg, Rrc, Rrc, Rr, Rrc, Ss, Sm, Ss
Gll^Fmw, Gll^Fmw, Gg, Gll^Fmw, Gll^Fp, Gg, Gll^Fmw, Gll^Fmw, Gll^Fp, Gg, Gg, Gg, Gg, Gg, Gg, Gll^Fmw, Rr, Gg, Gd, Gg, Gg, Gg, Gg, Gd, Gll, Gd, Gd, Gd, Gg, Aa^Fma, Gs, Gg, Gll^Fmw, Gll^Fmw, Gg, Gg, Gg, Gg, Gg, Gg, Gg, Gg, Rr, Ss, Sm, Sm
Gll^Fp, Gll^Fp, Gg, Gll^Fmw, Gg, Gg, Gll^Fmw, Gll^Fmw, Gg, Gg, Ce, Gg, Gg, Gg, Gg, Gg, Rr, Gg, Gd, Gd, Gg, Aa^Fma, Gg, Gll^Fmw, Gg, Gg, Gg, Gg, Gll^Fmw, Gg, Gs, Gd, Gd, Gg, Gg, Aa, Gg, Gd, Gll^Fmw, Gll^Fmw, Gg, Gg, Gg, Rrc, Rrc, Ss
Gg, Gll^Fp, Gg, Gll^Fp, Gll^Fmw, Gg, Gg, Gg, Gg, Ce, Ke, Ce, Gg, Aa^Fma, Gg, Rr, Gg, Gg, Gg, Gg, Gd, Gg, Gll^Fmw, Gg, Gll^Fmw, Gg, Gg, Gll^Fmw, Gg, Gg, Gg, Gs, Gd, Gd, Aa, Aa, Gg, Gg, Gg, Gg, Gll^Fmw, Gg, Gg, Ss, Ss, Rr
Gll^Fmw, Gg, Gg, Gg, Gll^Fmw, Gg, Gs, Gg, Gg, Ce, Re^Vct, Ce, Gg, Gg, Gg, Rr, Gg, Ce, Ce, Gg, Gd, Gd, Gg, Gll^Fmw, Gg, Gll^Fmw, Gg, Gg, Hh, Gg, Gg, Gs, Gd, Gd, Gg, Gll^Fmw, Gll^Fmw, Gg, Gg, Gg, Gg, Gg, Gg, Gg, Gg, Ss
Gg, Gg, Gll^Fmw, Gll^Fmw, Gs, Gs, Gg, Gg, Re^Vct, Gg, Gg, Gg, Gg, Gg, Rr, Rr, Gg, Ce, Ce, Ce, Ke, Gg, Gd, Gg, Gg, Gg, Hh, Hh, Mm, Hh, Hh, Gg, Gd, Gg, Gs, Gg, Gll^Fmw, Gg, Gg, Gg, Gg, Gg, Gd, Gg, Gg, Gg
Gg, Gg, Gg, Gll^Fmw, Gg, Gs, Ke, Ce, Ce, Ce, Gg, Gg, Rr, Rr, Ce, Gg, Gg, Gg, Gg, Re^Vct, Gg, Gg, Gg, Gd, Gg, Gg, Hh, Mm, Mm^Xm, Mm, Hh, Gg, Gg, Gg, Gll^Fmw, Gg, Gg, Gg, Gg, Gll^Fmw, Gg, Gg, Gd, Gg, Gg, Gg
Gg, Gg, Aa^Fma, Gg, Gd, Gg, Gg, Ce, Gg, Ce, Rr, Rr, Ce, Ce, Ce, Ce, Gg, Gg, Gg, Gg, Gll^Fmw, Gg, Gg, Gg, Gg, Gg, Gg, Hh, Hh^Vhh, Hh, Gg, Gg, Gg, Gg, Gll^Fmw, Gg, Gg, Gll^Fmw, Gg, Gg, Gg, Gg, Gg, Gd, Gd, Gg
Gg, Gg, Gg, Gg, Gg, Gg, Rr, Rr, Rr, Rr, Gg, Gg, Re^Vct, Ke, Gg, Gg, Gd, Gg, Gg, Gll^Fmw, Gll^Fmw, Gg, Gg, Gd, Gg, Gg, Gll^Fmw, Gg, Gg, Gg, Gg, Gg, Gll^Fmw, Gll^Fmw, Gg, Gg, Gg, Gg, Gg, Gg, Gg, Aa^Fma, Gg, Gg, Gg, Gg
Gg, Gg, Gg, Gg, Rr, Rr, Gd, Gd, Gs, Gg, Gs, Gd, Gg, Gg, Gg, Gd, Gg, Gg, Gg, Gg, Gg, Gg, Gg, Gg, Gg, Gll^Fmw, Gg, Gg, Gg, Gs, Gg, Gg, Gg, Gs, Gs, Gs, Gg, Gg, Aa^Fma, Gg, Gg, Gg, Gg, Gd, Gg, Gg
Gg, Gg, Rr, Rr, Gg, Gg, Gg, Gs, Gg, Gs, Gg, Gs, Gs, Gs, Gg, Gg, Gg, Gg, Gg, Gll^Fmw, Gg, Gg, Gg, Gg, Gg, Gg, Gg, Gg, Gg, Gg, Gll^Fmw, Gll^Fmw, Gll^Fmw, Gg, Gll^Fmw, Gll^Fmw, Gg, Gg, Gg, Gg, Gg, Gg, Gg, Gd, Gg, Gg
