Rp, Rp, Rp, Rp, Rp, Rp, Aa, Aa, Aa, Rp, Rp, Rb, Aa^Fda, Rb, Gll^Fdw, Rb, Rb, Rb, Rb, Rb, Rb, Rb, Aa, Rb, Rb, Rb, Gll^Fdw, Rb, Rb, Rb, Re, Rb, Re, Rb, Gll^Fdw, Gll^Fdw, Re, Re, Re, Rb, Aa^Fda, Aa^Fda, Aa, Rb, Re, Rb, Rd, Rb, Rr, Rrc, Ds, Ds, Ww, Ww, Wo, Wo
Gll^Fdw, Aa^Fda, Aa^Fda, Aa^Fda, Gll^Fdw, Aa, Aa, Aa, Gll^Fdw, Aa^Fda, Aa^Fda, Rp, Rp, Re^Vct, Ket, Ce, Rb, Aa^Fda, Aa, Aa, Aa, Aa, Aa, Rb, Gll^Fdw, Rb, Re, Re, Re, Re, Rb, Re, Rb, Re, Re, Rb, Gll^Fdw, Rb, Rb, Aa, Aa^Fda, Aa^Fda, Aa^Fda, Rb, Re, Re, Rd, Rd, Rr, Ds, Ds, Ds, Ww, Ww, Wo, Wo
Rb, Rb, Rb, Rb, Rb, Rb, Rb, Rb, Rb, Re, Rb, Rb, Rb, Ce, Cea, Ce, Re, Re, Rb, Re, Rd, Aa, Rb, Rb, Re, Re, Rd, Rb, Aa^Fda, Aa^Fda, Aa, Rb, Rb, Aa^Fda, Rb, Re, Rb, Re, Re, Aa, Aa^Fda, Aa, Rd, Rb, Rd, Rd, Re, Re, Rr, Ds, Ds, Ds, Ww, Ww, Wo, Wo
Rb, Rb, Rd, Rd, Rd, Rb, Rb, Rb, Rb, Rb, Cea, Ce, Ce, Rb, Re, Ce, Re, Re, Re, Re, Re, Re, Rd, Aa, Aa, Rd, Rb, Rb, Aa, Aa, Aa, Rb, Rd, Rb, Re, Re, Rb, Aa^Fda, Aa^Fda, Rb, Rb, Rb, Rb, Rd, Rb, Re, Aa, Aa, Rp, Ds, Ds, Ds, Ww, Ww, Wo, Wo
Rb, Rb, Rd, Aa, Re, Rd, Rb, Rb, Aa, Rb, Cea, Ket, Re^Vct, Re, Rb, Rb, Re, Rp, Rp, Gll^Fdw, Rb, Rb, Rd, Aa, Aa, Rb, Gll^Fdw, Rb, Aa^Fda, Re, Aa, Aa^Fda, Rb, Rd, Rd, Re, Aa^Fda, Aa^Fda, Rb, Rb, Ww, Ww, Ww, Rb, Rb, Rb, Gll, Aa, Rp, Ds, Ds, Ww, Ww, Ww, Wo, Wo
Rb, Rb, Aa, Aa, Rb, Re, Rb, Aa, Aa, Rb, Rd, Ce, Rb, Re, Re, Rb, Rb, Rb, Rb, Rp, Re, Rb, Rd, Rd, Rd, Rd, Rb, Gll^Fdw, Gll, Rb, Rb, Gll^Fdw, Re, Re, Re, Rb, Gll^Fdw, Re, Ww, Ww, Coa, Co, Co, Ww, Ww, Gll, Rb, Rb, Rp, Ds, Ww, Ww, Ww, Ww, Wo, Wo
Rb, Rb, Aa, Rb, Rb, Re, Re, Re, Aa, Rb, Rb, Rb, Gll^Fdw, Rb, Aa^Fda, Rb, Aa, Aa, Rb, Gll^Fdw, Rb, Re, Re, Gll, Rb, Rb, Gll, Rb, Re, Aa, Aa, Rb, Re, Gll^Fdw, Rb, Rb, Ww, Ww, Coa, Coa, Rb, Gll^Vct, Re, Co, Coa, Ww, Ww, Rb, Rp, Ww, Co, Ww, Ww, Wo, Wo, Wo
Rb, Rb, Rb, Rb, Re, Re, Aa, Aa, Aa, Rb, Rb, Gll^Fdw, Rb, Re, Rb, Aa, Aa^Fda, Aa, Rb, Rb, Re, Rb^Vo, Re, Rp, Rp, Rb, Rb, Re, Aa, Aa, Aa, Re, Rb, Gll, Ww, Ww, Co, Coa, Rb, Rb, Aa, Re, Rb, Re, Rb, Coa, Coa, Rp, Co, Co, Ds, Ww, Ww, Wo, Wo, Wo
Re, Rd, Re, Re, Re, Aa, Rd, Aa, Re, Re, Re, Re, Aa^Fda, Rb, Aa^Fda, Rd, Rb, Rb, Re, Rb, Re, Re, Rb, Rb, Aa, Rp, Rp, Re, Rb, Aa, Rb, Re, Ww, Ww, Co, Co, Rb, Rb, Rb, Rd, Aa, Aa, Aa, Aa, Re, Rb, Rb, Rp, Ds, Ds, Ww, Ww, Ww, Wo, Wo, Wo
Rb, Rd, Re, Aa, Aa, Rb, Rb, Rd, Rb, Re, Rb, Aa^Fda, Aa, Aa, Rd, Rd, Rb, Re, Aa^Fda, Aa, Aa^Fda, Rb, Rb, Re, Aa, Rb, Rd, Rp, Re, Rb, Ww, Ww, Co, Co, Rb, Re^Vct, Gll, Gll, Re, Rd, Aa, Rb^Vo, Rd, Re, Rd, Aa, Rb, Rp, Rb, Ds, Ww, Ww, Ww, Wo, Wo, Wo
Re, Rb, Rb, Rb, Aa, Re, Rb, Rb, Re, Re, Rd, Aa, Rd, Rd, Aa^Fda, Rb, Re, Gll^Fdw, Rb, Aa, Aa, Rb, Re, Aa, Re, Aa, Re, Re, Ww, Ww, Co, Coa, Rb, Rb, Rb, Gd, Coa, Coa, Coa, Rd, Rd, Rd, Rb, Re, Aa, Aa, Rd, Rp, Ds, Ds, Ww, Ww, Wo, Wo, Wo, Wo
Rb, Rd, Rb, Rb, Re, Rd, Rb, Rb, Rd, Rb, Rb, Rd, Rd, Rd, Rb, Rb, Re, Re, Rb, Rb, Rb, Aa, Re, Re, Re, Re, Ww, Ww, Coa, Co, Rd, Rr, Rr, Rb, Rb, Re, Coa, Koa, Rb^Vct, Gd, Ww, Ww, Ww, Re, Re, Re, Rd, Rp, Ds, Ds, Ww, Ww, Wo, Wo, Wo, Wo
Rd, Rd, Rd, Aa, Rb, Rb, Rd, Aa, Aa, Rb, Rb, Rb, Gll^Fdw, Rd, Rd, Rb, Re, Gll^Fdw, Rb, Rb, Rd, Re, Rd, Rd, Re, Rd, Ww, Coa, Re^Vct, Rd, Re, Re^Vo, Rd, Aa, Rr, Rb, Rb, Gd, Ww, Ww, Cha, Ch, Co, Ww, Ww, Rb^Vo, Rd, Rp, Ds, Ds, Ww, Ww, Wo, Wo, Wo, Wo
Rb, Rd, Rb, Rb, Rb, Rb, Rb, Aa, Rd, Aa, Rb, Rb, Rb, Rb, Re, Re, Rb, Rb^Dr, Rd, Gll, Re, Re, Rd, Rd, Rb, Rd, Ww, Co, Rb, Rb, Coa, Rb, Aa, Aa, Gll, Rr, Rr, Ww, Coa, Ch, Rb, Rb, Aa, Co, Ch, Ww, Re, Rp, Ds, Ds, Ww, Ww, Wo, Wo, Wo, Wo
Rb, Rb, Rb, Rb, Re, Re, Re, Rb, Rd, Rd, Re, Rb, Aa, Re, Rb, Aa, Aa, Rb, Aa, Re, Rd, Rd, Rd, Aa, Rd, Gll, Ww, Co, Re, Re, Koa, Coa, Gll, Rd, Ww, Ww, Co, Rp, Rp, Rb, Rb^Fdw, Aa^Fdw, Aa, Re, Rb^Dr, Ch, Rr, Ds, Ds, Ds, Ww, Ww, Wo, Wo, Wo, Wo
Rb, Rb, Aa, Aa, Ce, Ce, Ce, Rb, Rb, Rd, Aa, Aa, Re, Rb, Rd, Rb, Aa, Aa, Aa, Aa, Re, Gll, Re, Re, Re, Re, Ww, Coa, Rd, Coa, Coa, Rd^Vct, Ww, Ww, Ch, Ch, Rb, Rp^Vhcr, Rp, Rp, Rp, Aa, Rb^Vhcr, Rb, Rr, Rr, Co, Ds, Ds, Ds, Ww, Ww, Wo, Wo, Wo, Wo
Rb, Rb, Aa, Rb, Re^Vct, Ket, Cea, Rb, Rb, Aa, Aa, Aa, Aa, Rd, Rb, Rd, Rb, Aa, Gll, Re, Rb^Vo, Re, Rp, Re, Gll, Rd, Ww, Coa, Rd, Rd, Rb, Rb, Ww, Coa, Rb, Rb, Rb, Rp, Coa, Co, Co, Rr, Rr, Rr, Rb, Rb^Dr, Ch, Ds, Ds, Ww, Ww, Ww, Wo, Wo, Wo, Wo
Rb, Rb, Rb, Rb, Rb, Cea, Rb, Rb, Rb, Re, Rb, Rb, Aa, Aa, Re, Rb, Rb, Rb, Rb, Rb, Re, Rp, Rb, Rp, Rp, Gll, Ww, Coa, Rr, Rb, Rr, Rr, Rr, Rr, Rp, Re^Fdw, Re^Dr, Rp, Co, Co, Coa, Rr, Rb^Vo, Re^Fdw, Rb, Rb, Cha, Ds, Ds, Ww, Ww, Ww, Wo, Wo, Wo, Wo
Rp, Rp, Rp, Rp, Rp, Rp, Rp, Rp, Rp, Rp, Rp, Rp, Rp, Rb, Re, Rp, Rp, Rb, Rp, Rp, Rb, Rb, Aa, Rd, Rd, Rp, Ww, Co, Rb, Rr, Aa, Rb, Ww, Ch, Rr^Dr, Rp, Rp, Rp, Co, Ko, Co, Rr, Rr, Rb, Rb, Rb, Cha, Ds, Ww, Ww, Ww, Wo, Wo, Wo, Wo, Wo
Rb, Rb, Rb, Rb, Re^Vct, Ce, Cea, Rb, Rb, Rb, Rb, Rb, Rb, Rb, Rb, Rb, Rb, Rp, Rb, Rb, Rb, Rd, Aa, Aa, Rd, Rd, Ww, Co, Rb, Aa, Aa, Rb, Ww, Co, Re, Re, Rr, Co, Coa, Co, Co, Coa, Rr, Rp^Vhcr, Ww, Re, Ch, Ds, Ww, Ww, Wo, Wo, Wo, Wo, Wo, Wo
Rb, Aa, Aa, Rb, Rb, Ket, Ce, Ce, Rb, Rb, Rb, Rb, Rb, Aa, Aa, Aa, Rb, Rb, Rb, Rb, Rb, Rd, Rd, Rb, Rd, Rd, Ww, Co, Rb, Re^Vct, Rd, Aa, Ww, Co, Rb, Re, Rp^Vhcr, Rr, Rr, Coa, Rp, Rp, Wo, Wo^Bw\r, Wo^Bw\r, Ww, Ww, Ww, Ww, Ww, Wo, Wo, Wo, Wo, Wo, Wo
Ds, Rb, Ds, Rb, Ds, Ce, Ds, Rb, Ds, Rb, Ds, Rb, Ds, Rb, Ds, Rb, Ds, Rb, Ds, Rb, Ds, Rb, Ds, Rd, Ds, Rd, Ww, Coa, Ds, Rb, Ds, Rb, Ww, Cha, Ds, Ds, Ds, Rr, Rp, Rp, Wo, Wo^Bw\r, Wo^Bw\r, Wo, Wo, Wo^Bw\, Wo^Bw\r, Ww, Wo, Wo, Wo, Wo, Wo, Wo, Wo, Wo
Ds, Ds, Ds, Ds, Ds, Ds, Ds, Ds, Ds, Ds, Ds, Ds, Ds, Ds, Ds, Ds, Ds, Ds, Ds, Ds, Ds, Ds, Ds, Ds, Ds, Ds, Ww, Co, Ds, Ds, Ds, Ds, Ww, Cha, Ds, Ds, Ds, Ds, Wo, Wo^Bw\r, Wo^Bw\r, Wo, Wo, Wo^Bw\r, Wo^Bw\, Wo, Wo, Wo, Wo, Wo, Wo, Wo, Wo, Wo, Wo, Wo
Ww, Ds, Ww, Ds, Ww, Ds, Ww, Ds, Ww, Ds, Ww, Ds, Ww, Ds, Ww, Ds, Ww, Ds, Ww, Ds, Ww, Ds, Ww, Ds, Ww, Ds, Ww, Co, Ww, Ds, Ww, Ds, Ww, Ww, Ww, Ww, Ww, Ww, Wo, Wo, Wo, Wo^Bw\, Wo^Bw\r, Wo, Wo, Wo, Wo, Wo, Wo, Wo, Wo, Wo, Wo, Wo, Wo, Wo
Ww, Ww, Ww, Ww, Ww, Ww, Ww, Ww, Ww, Ww, Ww, Ww, Ww, Ww, Ww, Ww, Ww, Ww, Ww, Ww, Ww, Ww, Ww, Ww, Ww, Ww, Ww, Ww, Ww, Ww, Ww, Ww, Ww, Ww, Ww, Ww, Ww, Ww, Wo, Wo, Wo, Wo, Wo, Wo, Wo, Wo, Wo, Wo, Wo, Wo, Wo, Wo, Wo, Wo, Wo, Wo
Ww, Ww, Ww, Ww, Ww, Ww, Ww, Ww, Ww, Ww, Ww, Ww, Ww, Ww, Ww, Ww, Ww, Ww, Ww, Ww, Ww, Ww, Ww, Ww, Ww, Ww, Ww, Ww, Ww, Ww, Ww, Ww, Wo, Ww, Wo, Ww, Wo, Wo, Wo, Wo, Wo, Wo, Wo, Wo, Wo, Wo, Wo, Wo, Wo, Wo, Wo, Wo, Wo, Wo, Wo, Wo
Wo, Wo, Wo, Wo, Wo, Wo, Wo, Wo, Wo, Wo, Wo, Wo, Wo, Wo, Wo, Wo, Wo, Wo, Wo, Wo, Wo, Wo, Wo, Wo, Wo, Wo, Wo, Wo, Wo, Wo, Wo, Wo, Wo, Wo, Wo, Wo, Wo, Wo, Wo, Wo, Wo, Wo, Wo, Wo, Wo, Wo, Wo, Wo, Wo, Wo, Wo, Wo, Wo, Wo, Wo, Wo
Wo, Wo, Wo, Wo, Wo, Wo, Wo, Wo, Wo, Wo, Wo, Wo, Wo, Wo, Wo, Wo, Wo, Wo, Wo, Wo, Wo, Wo, Wo, Wo, Wo, Wo, Wo, Wo, Wo, Wo, Wo, Wo, Wo, Wo, Wo, Wo, Wo, Wo, Wo, Wo, Wo, Wo, Wo, Wo, Wo, Wo, Wo, Wo, Wo, Wo, Wo, Wo, Wo, Wo, Wo, Wo
