Ms, Ms, Ms, Ms, Ms, Ms, Ms, Ms, Ms, Ms, Ms, Aa^Fpa, Ha, Ms, Ha, Ms, Aa, Aa^Fma, Aa^Fma, Ms, Ms, Ms, Ms, Ms, Ms, Ms, Aa, Aa, Aa^Fpa, Aa, Aa, Aa, Aa, Aa, Aa, Aa, Aa, Aa, Aa, Aa, Aa, Aa, Aa^Fpa, Aa, Aa, Aa, Aa, Aa, Aa, Aa, Aa, Aa, Aa, Aa, Aa, Aa, Aa, Aa, Rra, Aa, Ai, Ww, Ww, Wo, Wo, Wo, Wo, Wo, Wo, Wo
Ms, Ms, Ha, Ms, Ms, Ms, Ms, Ms, Ms, Ms, Ms, Ha, Ha, Ha, Aa^Fpa, Hh, Ha, Aa^Fma, Ha, Aa^Fma, Ms, Ms, Ms, Ms, Ms, Ms, Aa^Fpa, Aa^Fma, Aa^Fma, Aa, Aa, Aa, Ai, Aa, Aa, Aa, Aa, Aa, Aa, Aa, Aa, Aa, Aa^Fpa, Aa^Fpa, Aa^Fpa, Aa, Aa, Aa, Gs, Gs, Aa, Aa, Gs, Aa, Aa^Fma, Aa^Fma, Aa^Fpa, Aa, Rra, Aa, Ds, Ww, Ww, Wo, Wo, Wo, Wo, Wo, Wo, Wo
Ms, Ha, Cea, Ha, Ha, Ha, Ha, Ha, Ha, Ms, Ha, Ha, Aa^Fpa, Aa^Fpa, Aa^Fma, Aa^Fma, Aa^Fpa, Ha, Aa, Ha, Aa^Fpa, Aa^Fpa, Ha, Ms, Ha^Vhha, Aa^Fpa, Aa, Aa^Fpa, Aa^Fma, Aa^Fpa, Aa, Ai, Ai, Ai, Aa, Aa, Aa, Aa, Aa, Aa, Gs, Aa, Aa, Aa^Fpa, Aa, Aa^Fpa, Aa, Aa, Aa, Aa, Aa, Aa, Aa, Aa, Aa^Fpa, Aa^Fma, Aa, Aa, Rra, Aa, Ds, Ai, Ww, Ww, Wo, Wo, Wo, Wo, Wo, Wo
Ha, Ha, Kea, Cea, Cea, Cea, Aa^Vca, Aa, Aa, Hh, Gs, Aa, Aa^Fpa, Aa^Fpa, Aa^Fpa, Aa^Fpa, Aa, Aa, Aa, Aa, Aa^Fma, Aa^Fma, Aa^Fpa, Ha, Aa, Aa, Aa, Aa, Aa, Aa, Aa, Ai, Ai, Ai, Aa, Aa, Aa, Aa, Aa, Aa, Aa, Aa, Aa, Aa, Aa, Aa, Aa, Aa, Aa, Aa, Aa, Aa, Aa, Aa, Aa, Aa, Aa, Aa, Rra, Aa, Ds, Ai, Ww, Ww, Wo, Wo, Wo, Wo, Wo, Wo
Aa, Cea, Cea, Cea, Cea, Cea, Aa, Aa, Rra, Aa, Gs, Aa, Aa, Aa, Aa, Aa, Gs, Aa, Aa, Aa, Aa, Aa^Fpa, Aa, Aa, Aa, Aa, Aa, Aa, Aa, Aa, Aa, Aa, Aa, Aa, Aa, Aa, Aa, Aa, Aa, Aa, Aa, Aa, Aa, Aa, Aa, Aa, Gs, Aa, Aa, Aa, Aa, Aa, Aa, Aa, Aa, Aa, Aa, Aa, Rra, Aa, Aa, Ai, Ai, Ww, Ww, Wo, Wo, Wo, Wo, Wo
Rra, Rra, Rra, Rra, Rra, Rra, Rra, Rra, Ww, Rra, Rra, Rra, Rra, Aa, Rra, Gs, Gs, Gs, Aa, Aa, Aa, Aa, Aa, Aa, Aa, Aa, Aa, Aa, Aa, Aa, Aa, Aa, Aa, Aa, Aa, Aa, Aa, Aa, Aa, Aa, Aa, Aa, Aa, Aa, Aa, Aa, Aa, Aa^Fpa, Aa^Fma, Aa, Aa^Fma, Aa, Aa, Aa, Aa, Aa, Aa, Aa, Aa, Rra, Aa^Voa, Ai, Ai, Ww, Ww, Wo, Wo, Wo, Wo, Wo
Ww, Ds, Ww, Ww, Ww, Ww, Ww, Ww, Wo, Ww, Wo, Aa, Aa, Rra, Aa, Rra, Rra, Rra, Rra, Aa, Rra, Aa, Aa, Aa, Aa, Aa, Aa, Aa, Aa, Aa, Aa^Fpa, Aa^Fpa, Aa^Fma, Aa, Aa, Aa, Aa, Aa, Aa, Aa, Aa, Aa, Aa, Aa, Aa, Aa, Aa, Aa^Fma, Aa^Fpa, Aa^Fma, Aa^Fpa, Aa, Aa, Aa, Gs, Aa, Gs, Aa, Aa, Rra, Rra, Aa, Ai, Ww, Ww, Wo, Wo, Wo, Wo, Wo
Wo, Ww, Wo, Wo, Wo, Wo, Wo, Wo, Ai, Wo, Wo, Wo, Ds, Aa, Ds, Aa, Aa, Aa, Aa, Rra, Aa, Rra, Rra, Aa, Aa, Aa, Aa, Aa, Aa, Aa, Aa, Aa^Fma, Aa^Fma, Aa^Fma, Aa, Aa, Aa, Aa, Aa, Aa, Aa, Gs, Aa, Aa, Aa, Aa, Aa, Aa, Aa, Aa, Aa, Aa, Aa, Aa, Aa, Gs, Aa, Aa, Aa, Aa, Aa, Rra, Aa, Ww, Ww, Wo, Wo, Wo, Wo, Wo
Wo, Wo, Wo, Wo, Ai, Wo, Wo, Ai, Ai, Wo, Wo, Wo, Wo, Ds, Ds, Ds, Ds, Aa, Aa, Aa, Aa, Aa, Aa, Rra, Rra, Rra, Rra, Aa, Rra, Aa, Gd^Vhr, Aa, Aa, Aa^Fpa, Aa, Aa, Aa, Aa, Aa, Aa, Aa, Aa, Aa, Aa, Aa, Aa, Aa, Aa, Aa, Aa, Aa, Aa, Aa, Aa, Aa, Aa, Aa, Aa, Aa, Aa, Aa, Rra, Aa, Ww, Ww, Wo, Wo, Wo, Wo, Wo
Ww, Wo, Ww, Wo, Ai, Wo, Ww, Wo, Wo, Ai, Wo, Ai, Wo, Wo, Ai, Wo, Wo, Ds, Wo, Ww, Ww, Aa, Ww, Aa, Aa, Aa, Aa, Rra, Aa, Rra, Rra, Rra, Rra, Aa, Rra, Aa, Aa, Aa, Aa, Aa, Aa, Aa, Aa, Gs, Aa, Aa, Aa, Aa, Aa, Aa, Aa, Aa, Aa, Aa, Aa, Aa, Aa, Aa, Aa, Aa, Aa, Rra, Aa, Ww, Ww, Wo, Wo, Wo, Wo, Wo
Ww, Ww, Ww, Ww, Ds, Ww, Ds, Ww, Ww, Wo, Wo, Wo, Wo, Wo, Ai, Wo, Wo, Wwr, Wo, Wo, Wo, Ww, Ww, Ww, Ww, Aa, Ww, Aa, Ds, Aa, Aa, Aa, Aa, Rra, Aa, Rra, Rra, Aa, Aa, Aa, Aa, Aa, Aa, Aa, Aa, Aa, Aa, Aa, Aa, Aa, Gs, Aa, Aa, Aa, Aa, Aa, Aa, Aa, Aa, Aa, Aa, Rra, Aa, Ww, Ww, Wo, Wo, Wo, Wo, Wo
Ds, Ds, Ds, Ds, Aa, Ds, Ds, Ww, Ww, Ww, Ww, Wo, Wo, Wwr, Wwr, Wwr, Ai, Ai, Wo, Wo, Ai, Ai, Wo, Ww, Wwr, Ww, Wwr, Ww, Wo, Ds, Ds, Gs, Ds, Aa, Aa, Aa, Aa, Rra, Rra, Aa, Aa, Aa, Aa, Aa, Aa, Aa, Aa, Aa, Aa, Aa, Aa, Aa, Aa, Aa, Aa, Aa, Aa, Aa, Aa, Aa, Aa, Rra, Aa, Ww, Ww, Wo, Wo, Wo, Wo, Wo
Aa, Aa, Aa, Aa, Aa^Fpa, Aa, Aa, Ds, Aa, Ww, Aa, Ds, Ds, Ds, Ds, Wwr, Ds, Wo, Ww, Wo, Ww, Wo, Wo, Wo, Wwr, Wo, Ai, Wwr, Wo, Wo, Wwr, Ds, Wwr, Ds, Ds, Aa, Ww, Aa, Aa, Rra, Rra, Aa, Aa, Aa, Aa, Aa, Aa, Aa, Aa, Aa, Aa, Aa, Aa, Aa, Aa, Aa, Aa, Aa, Aa, Aa, Aa, Rra, Aa, Ai, Ww, Wo, Wo, Wo, Wo, Wo
Aa, Aa^Fma, Aa^Fpa, Aa^Fpa, Aa^Fpa, Aa, Aa, Aa, Aa, Aa, Aa, Aa, Aa, Aa, Aa, Ds, Aa, Ds, Ww, Ww, Ww, Wo, Wo, Ai, Wwr, Wwr, Wwr, Wwr, Wo, Wo, Wwr, Wwr, Wo, Wo, Wo, Wo, Wo, Ww, Ww, Aa, Aa, Rra, Rra, Aa, Aa, Aa, Aa, Aa, Aa, Aa, Aa, Aa, Aa, Aa, Aa, Aa, Gs, Aa, Aa, Gs, Aa, Rra, Aa, Ai, Ww, Wo, Wo, Wo, Wo, Wo
Aa, Aa^Fma, Aa, Aa^Fma, Aa, Aa^Fpa, Aa, Aa, Aa, Aa, Aa, Aa^Fpa, Aa^Fpa, Aa^Fpa, Aa^Fpa, Aa, Aa, Aa, Aa, Aa, Aa, Ww, Aa, Wo, Ww, Wwr, Ds, Wwr, Wo, Wo, Wwr, Wwr, Wo, Wo, Wo, Wo, Wo, Wo, Wo, Ww, Ww, Aa, Aa, Rra, Rra, Aa, Aa, Aa, Aa, Aa, Aa, Aa, Aa, Aa, Ai, Aa, Gs, Gs, Aa, Aa, Aa, Rra, Aa, Ai, Ww, Wo, Wo, Wo, Wo, Wo
Aa, Aa, Aa, Aa, Aa, Aa, Rra, Aa, Rra, Aa, Rra, Aa, Rra, Aa, Rra, Aa, Rra, Aa, Rra, Aa, Rra, Aa, Aa, Aa, Aa, Ww, Aa, Ds, Ds, Ds, Ds, Wwr, Wo, Wo, Wo, Wo, Ai, Ai, Ai, Wo, Wo, Ww, Aa, Aa, Rra, Aa, Aa, Aa, Aa, Aa, Gs, Aa, Aa, Ai, Ai, Ai, Aa, Aa, Aa, Aa, Rra, Rra, Aa, Ai, Ww, Wo, Wo, Wo, Wo, Wo
Rra, Rra, Rra, Rra, Rra, Rra, Rra, Rra, Gs, Rra, Aa, Rra, Aa, Rra, Aa, Rra, Aa, Rra, Aa, Rra, Aa, Rra, Rra, Aa, Rra, Aa, Aa, Aa, Aa, Ds, Aa, Aa, Ds, Ww, Ww, Wo, Wo, Ai, Wo, Wo, Wo, Ww, Aa, Aa, Rra, Aa, Aa, Aa, Gs, Gs, Aa, Aa, Gs, Ai, Ai, Ai, Aa, Aa, Aa, Rra, Aa, Aa, Ai, Ai, Ww, Wo, Wo, Wo, Wo, Wo
Aa, Aa, Aa, Aa, Aa, Aa, Aa, Aa, Aa, Aa, Aa^Fpa, Aa, Aa, Aa, Aa, Aa, Aa, Aa, Aa, Aa, Aa, Aa, Aa, Rra, Aa, Rra, Rra, Aa, Rra, Aa, Aa, Aa, Aa, Aa, Aa, Ww, Ww, Wo, Wo, Wo, Wo, Ww, Ww, Aa, Rra, Aa, Aa, Aa, Aa, Aa, Aa, Aa, Aa, Aa, Aa, Aa, Aa, Aa, Aa, Rra, Aa, Aa, Aa, Ai, Ww, Wo, Wo, Wo, Wo, Wo
Ms, Ms, Ms, Aa, Ms, Ms, Ms, Aa, Aa, Aa^Fpa, Aa, Aa^Fpa, Aa, Gs, Gs, Gs, Aa, Aa, Aa, Aa, Aa, Aa, Gs, Aa, Aa, Aa, Aa, Rra, Aa, Rra, Rra, Rra, Rra, Aa, Aa, Aa, Aa, Ww, Ww, Wo, Wo, Wo, Ww, Aa, Rra, Gs, Aa, Aa, Aa, Aa, Aa, Aa, Aa, Aa, Aa, Aa, Gs, Aa, Aa, Rra, Aa, Aa, Aa, Ww, Ww, Wo, Wo, Wo, Wo, Wo
Ms, Ms, Ms, Ms, Ms, Ms, Ms, Ms, Ms, Hh, Ha, Aa, Aa, Aa, Aa, Aa, Aa, Aa, Aa^Fma, Aa^Fma, Aa^Fma, Aa, Aa, Aa, Aa, Aa, Aa, Gs, Aa, Aa, Aa, Aa, Aa, Rra, Rra, Aa, Aa, Ww, Ww, Wo, Wo, Wo, Ww, Aa, Aa, Rra, Aa, Aa, Aa, Aa, Gs, Aa, Aa, Gs, Aa, Aa, Aa, Aa, Rra, Rra, Aa, Aa, Ww, Ww, Ww, Wo, Wo, Wo, Wo, Wo
Ms, Ms, Ms, Ms, Ms, Ms, Ms, Ms, Ms, Ms, Ms, Ha, Ha, Aa, Aa, Aa, Aa, Aa^Fma, Aa, Aa^Fma, Aa^Fma, Aa, Aa, Aa, Aa, Aa, Aa, Aa, Aa, Aa, Aa, Aa, Aa, Aa, Rra, Aa, Aa, Aa, Ww, Wo, Wo, Wo, Ww, Aa, Aa, Rra, Aa, Aa, Aa, Gs, Aa, Aa, Aa, Aa, Aa, Aa, Aa, Aa, Rra, Aa, Aa, Ww, Ww, Ww, Wo, Wo, Wo, Wo, Wo, Wo
Ms, Ms, Ms, Ms, Ms, Ms, Ms, Ms, Ms, Ms, Ms, Ms, Ms, Ha, Ha, Aa, Aa, Aa, Aa, Aa, Aa, Aa, Aa, Aa, Aa, Aa, Aa, Aa, Aa, Aa, Aa, Aa, Aa, Aa, Aa, Rra, Rra, Aa, Aa, Ww, Wo, Wo, Wo, Ww, Aa, Rra, Aa, Aa, Aa, Aa, Aa, Aa, Gs, Aa, Co, Coa, Coa, Aa, Rra, Aa, Ww, Ww, Ww, Ww, Wo, Wo, Wo, Wo, Ai, Wo
Ms, Ms, Ms, Ms, Ms, Ms, Ms, Ms, Ms, Ms, Ms, Ms, Ms, Mm, Ha, Gs, Gs, Gs, Aa, Gs, Aa, Aa, Aa, Aa, Aa, Aa, Aa, Aa, Gs, Aa, Aa, Gs, Aa, Aa, Aa, Aa, Rra, Aa, Aa, Ww, Wo, Wo, Wo, Ww, Aa, Rra, Rra, Gs, Aa, Aa, Aa, Aa, Coa, Aa, Aa, Re^Vct, Rra, Rra, Coa, Aa, Ww, Ww, Ww, Ww, Wo, Wo, Wo, Ai, Ai, Wo
Ms, Ms, Ms, Ms, Ms, Ms, Ms, Ms, Ms, Ms, Ms, Ms, Ms, Ms, Ms, Ha, Hh, Aa, Aa, Aa, Aa, Aa, Aa^Fma, Aa, Gs, Aa, Aa, Aa, Aa, Gs, Aa, Aa, Aa, Gs, Gs, Aa, Rra, Aa, Aa, Ww, Wo, Wo, Wo, Ww, Aa, Aa, Aa, Rra, Rra, Aa, Coa, Co, Re^Vct, Aa, Rra, Rra, Gs, Aa, Re^Vct, Co, Ww, Ww, Ww, Ww, Wo, Wo, Wo, Wo, Wo, Wo
Ms, Ms, Ms, Ms, Ms, Ms, Ms, Ms, Ms, Ms, Ms, Ms, Ms, Ms, Ms, Ms, Hh, Aa, Aa, Aa, Aa^Fma, Aa^Fma, Aa^Fma, Aa^Fma, Aa^Fma, Aa, Aa, Aa, Aa, Aa, Aa, Aa, Aa, Gs, Aa, Aa, Rra, Aa, Aa, Ww, Wo, Wo, Wo, Ww, Ds, Aa, Aa, Aa, Coa, Rra, Rra, Aa, Rra, Rra, Coa, Rra, Rra, Gs, Aa, Coa, Ww, Ww, Ww, Ww, Wo, Wo, Wo, Wo, Wo, Wo
Ms, Ms, Ms, Ms, Ms, Ms, Ms, Ms, Ms, Ms, Ms, Ms, Ms, Ms, Ms, Ms, Ha, Aa, Aa^Fma, Aa^Fma, Aa, Aa^Fma, Aa^Fma, Aa^Fma, Aa^Fma, Aa, Aa, Aa, Aa, Aa, Aa, Aa, Aa, Aa, Aa, Aa, Rra, Aa, Aa, Ww, Wo, Wo, Wo, Ww, Ww, Ds, Ds, Ww, Co, Aa, Aa, Rra, Coa, Coa, Koa, Coa, Coa, Rra, Aa, Aa, Ww, Ww, Ww, Wo, Wo, Wo, Wo, Wo, Wo, Wo
Ms, Ms, Ms, Ms, Ms, Ms, Ms, Ms, Ms, Ms, Ms, Ms, Ms, Ms, Ms, Ms, Ha, Aa, Aa, Aa^Fma, Aa^Fma, Aa^Fma, Aa, Aa^Fma, Aa, Aa, Aa, Aa, Aa, Aa^Fpa, Aa^Fpa, Aa, Aa, Aa, Aa, Aa, Rra, Aa, Aa, Ww, Wo, Ai, Wo, Wo, Wo, Ww, Ww, Ww, Co, Re^Vct, Aa, Rra, Rra, Coa, Coa, Coa, Rra, Rra, Re^Vct, Coa, Ww, Ww, Wo, Wo, Wo, Wo, Wo, Wo, Wo, Wo
Ms, Ms, Ms, Ms, Ms, Ms, Ms, Ms, Ms, Ms, Ms, Ms, Ms, Ms, Ms, Ms, Ms, Gs, Aa, Aa, Aa, Aa, Aa, Aa, Aa, Aa, Gs, Aa, Aa^Fpa, Aa^Fpa, Aa^Fpa, Aa^Fpa, Aa^Fpa, Aa, Aa, Aa, Rra, Aa, Aa, Ww, Ww, Wo, Wo, Wo, Wo, Wo, Wo, Ww, Ww, Coa, Co, Aa, Rra, Rra, Rra, Rra, Aa, Gs, Coa, Coa, Ww, Ww, Wo, Wo, Wo, Wo, Wo, Wo, Wo, Wo
Ms, Ms, Ms, Ms, Ms, Ms, Ms, Ms, Ms, Ms, Ms, Ms, Ms, Aa^Fpa, Ms, Ms, Ms, Ha, Ha, Aa, Aa, Aa, Aa, Aa, Aa, Aa, Aa, Aa, Aa, Aa^Fpa, Aa^Fpa, Aa^Fma, Aa^Fma, Aa, Aa, Aa, Aa, Rra, Rra, Aa, Aa, Ww, Ww, Wo, Wo, Wo, Wwr, Wwr, Ww, Ww, Ww^Bsb/, Rra, Coa, Aa, Re^Vct, Aa, Coa, Aa, Ww, Ww, Ww, Ww, Wo, Wo, Wo, Wo, Wo, Wo, Wo, Wo
Ms, Ms, Ms, Ms, Ms, Ms, Ms, Ms, Ms, Ms, Ms, Ms, Ms, Ms, Ms, Ms, Ms, Ms, Ms, Ha, Ha, Aa, Aa, Aa, Aa, Aa, Aa, Aa, Aa, Aa, Aa^Fpa, Aa^Fma, Aa^Fma, Aa^Fma, Aa^Fpa, Aa, Aa, Aa, Aa, Rra, Aa, Aa, Aa, Ww, Ww, Wwr, Ai, Ai, Ai^Bsb/, Ww^Bsb/, Ww, Ww, Ww, Coa, Co, Co, Ww, Ww, Ww, Ww, Wo, Wo, Wo, Wo, Wo, Wo, Wo, Wo, Wo, Wo
Ms, Ms, Ms, Ms, Ms, Ms, Ms, Ms, Ms, Ms, Ms, Ms, Ms, Ms, Ms, Ms, Ms, Ms, Ms, Ms, Aa^Fpa, Aa, Aa, Aa, Aa, Aa, Aa, Aa, Aa, Aa, Aa, Aa^Fma, Aa^Fpa, Aa^Fpa, Aa^Fpa, Aa, Aa, Aa, Aa, Rra, Rra, Aa, Aa, Aa, Aa, Ww, Ww^Bsb/, Ww^Bsb/, Wwr, Wwr, Wwr, Wo, Wwr, Ai, Ai, Ai, Ww, Ww, Wo, Wo, Wo, Wo, Wo, Wo, Wo, Wo, Ai, Ai, Wo, Wo
Ms, Ms, Ms, Ms, Ms, Ms, Ms, Ms, Ms, Ms, Ms, Ms, Ms, Ms, Ms, Ms, Ms, Ms, Ha, Ha, Aa^Fpa, Aa^Fpa, Aa^Fma, Gs, Aa^Fma, Aa, Aa, Aa, Aa, Aa, Aa, Aa^Fma, Aa, Aa, Gs, Aa, Re^Vct, Aa, Aa, Gs, Aa, Rra, Rra, Aa, Rra, Rra, Aa, Ww, Ai, Wwr, Wwr, Wwr, Wo, Wo, Ai, Ai, Wo, Wo, Wo, Wo, Wo, Wo, Wo, Wo, Wo, Wo, Ai, Ai, Wo, Wo
Ms, Ms, Ms, Ms, Ms, Ms, Ms, Ms, Ms, Ms, Ms, Ms, Ms, Ms, Ms, Ms, Ms, Ms, Aa, Aa, Aa^Fpa, Aa^Fma, Aa^Fpa, Aa, Aa, Aa, Aa, Aa, Ce, Aa, Aa, Aa, Aa, Aa, Ce, Ce, Ke, Aa, Aa, Aa, Aa^Fma, Aa^Fma, Aa, Rra, Aa, Aa, Aa, Ds, Ds, Ai, Ww, Wo, Wo, Wo, Wo, Wo, Wo, Wo, Wo, Wo, Wo, Wo, Wo, Wo, Wo, Wo, Wo, Wo, Wo, Wo
Ms, Ms, Ms, Ms, Ms, Ms, Ms, Ms, Ms, Ms, Ms, Ms, Mm, Ms, Ms, Mm, Ms, Ms, Aa, Aa, Aa^Fma, Aa^Fma, Aa^Fma, Aa^Fpa, Aa^Fpa, Aa, Gs, Aa, Ce, Ke, Ce, Aa, Gs, Aa, Aa, Ce, Ce, Ce, Aa^Fma, Aa^Fpa, Aa^Fma, Aa, Aa^Fpa, Rra, Aa, Aa, Aa, Aa, Aa, Aa, Ww, Ww, Wo, Wo, Wo, Wo, Wo, Wo, Wo, Wo, Wo, Wo, Wo, Wo, Wo, Wo, Wo, Wo, Wo, Wo
Ms, Ms, Ms, Ms, Ms, Ms, Ms, Ms, Ms, Ms, Ms, Ms, Ms, Ms, Ms, Ms, Mm, Ms, Aa^Fma, Aa^Fma, Aa^Fma, Aa^Fpa, Aa^Fma, Aa^Fma, Aa^Fpa, Gs, Aa, Re^Vct, Ce, Ce, Aa, Gs, Gs, Aa, Aa, Aa, Aa, Aa, Aa, Aa, Aa^Fpa, Aa, Rra, Rra, Aa, Aa, Aa, Aa, Aa, Aa, Ww, Ww, Ww, Wo, Wo, Wo, Wo, Wo, Wo, Wo, Wo, Wo, Wo, Wo, Wo, Wo, Wo, Wo, Wo, Wo
Ms, Ms, Ms, Ms, Ms, Ms, Ms, Ms, Ms, Ms, Ms, Ms, Ms, Ms, Ms, Ms, Ms, Ms, Aa, Aa^Fma, Aa, Aa^Fma, Aa, Aa^Fpa, Aa, Aa^Fpa, Gs, Aa, Aa, Aa, Aa, Aa, Aa, Aa, Aa, Aa, Aa, Aa, Aa, Aa, Aa, Rra, Aa, Aa, Gs, Aa, Ce, Aa, Aa, Aa, Ds, Ww, Ww, Wo, Wo, Wo, Wo, Wo, Wo, Wo, Wo, Wo, Ai, Wo, Wo, Wo, Wo, Wo, Wo, Wo
Ms, Ms, Ms, Ms, Ms, Ms, Ms, Ms, Ms, Ms, Ms, Ms, Ms, Ms, Ms, Aa^Vla, Aa, Aa, Ms, Aa, Ms, Ha, Ha, Gs, Ha, Gs, Aa, Aa, Aa, Aa, Aa, Aa, Aa, Aa, Aa, Ce, Ke, Ce, Ce, Gs, Aa, Rra, Aa, Aa, Aa, Ce, Ce, Ke, Ce, Aa, Ds, Ds, Ww, Ww, Wo, Wo, Wo, Wo, Wo, Wo, Wo, Ai, Ai, Ai, Wo, Wo, Wo, Wo, Wo, Wo
Ms, Ms, Ms, Ms, Ms, Ms, Ms, Ms, Ms, Ms, Ms, Ms, Ms, Ms, Gs, Aa, Ms, Mm, Ms, Ms, Ms, Ms, Ms, Ha, Ha, Ha, Aa, Aa, Aa, Aa, Aa, Gs, Aa, Aa, Aa, Ce, Re^Vct, Ce, Gs, Gs, Rra, Rra, Aa, Aa, Aa, Re^Vct, Gs, Ce, Aa, Aa, Aa, Ds, Ww, Ww, Wo, Wo, Wo, Wo, Wo, Wo, Wo, Wo, Wo, Wo, Wo, Wo, Wo, Wo, Wo, Wo
Ms, Ms, Ms, Ms, Ms, Ms, Ms, Ms, Ha, Ms, Ha, Ms, Aa, Aa, Gs, Aa, Ms, Ms, Ms, Ms, Ms, Mm, Ms, Ms, Hh, Hh, Ha, Aa, Aa, Aa, Aa, Aa, Aa, Aa, Aa, Aa, Aa, Aa, Rra, Rra, Aa, Aa, Aa, Aa, Aa, Aa, Aa, Aa, Aa, Aa, Aa, Aa, Ww, Ww, Wo, Wo, Wo, Wo, Wo, Wo, Wo, Wo, Wo, Wo, Wo, Wo, Wo, Wo, Wo, Wo
Ms, Ms, Ms, Ms, Ms, Ms, Ms, Ms, Aa, Ha, Aa, Ha, Aa, Aa, Aa, Ms, Ms, Ms, Ms, Ms, Ms, Ms, Ms, Mm, Ha, Hh, Ha, Ha, Ha, Ha, Ha, Aa, Aa, Aa, Aa, Aa, Aa, Aa, Rra, Aa, Aa, Aa, Aa, Aa, Aa, Aa, Aa, Aa, Aa, Aa, Aa, Aa, Ww, Ww, Wo, Wo, Wo, Wo, Wo, Wo, Wo, Wo, Wo, Wo, Wo, Wo, Wo, Wo, Wo, Wo
