Aa, Aa, Aa, Aa, Aa, Aa^Fpa, Aa^Fpa, Aa^Fpa, Aa, Aa^Fpa, Aa^Fpa, Aa^Fpa, Aa^Fdw, Aa^Fpa, Aa, Aa^Fpa, Aa^Fpa, Aa, Aa^Fpa, Aa^Fpa, Aa^Fpa, Aa^Fpa, Aa, Aa, Aa^Fpa, Aa^Fpa, Aa^Fpa, Aa^Fpa, Aa^Fpa, Aa^Fpa, Aa, Aa^Fpa, Aa, Aa, Aa, Aa^Fpa, Aa^Fpa, Aa, Aa, Aa, Aa, Aa, Aa^Fpa, Re, Aa, Aa, Aa, Aa, Re, Aa^Fpa, Aa^Fda, Aa^Fpa, Aa^Fda, Aa, Re, Aa^Fpa, Aa^Fpa, Aa, Re, Aa^Fpa, Aa, Aa^Fpa, Aa, Aa, Aa, Aa
Aa, Aa, Aa^Fpa, Aa, Aa^Fpa, Aa^Fpa, Aa^Fpa, Aa^Fpa, Aa^Fdw, Aa^Fma, Aa, Aa^Fdw, Aa^Fpa, Aa^Fpa, Aa^Fpa, Aa^Fpa, Aa^Fpa, Aa, Aa^Fma, Aa, Aa^Fpa, Aa^Fpa, Aa, Aa, Aa, Aa^Fpa, Aa^Fpa, Aa^Fpa, Aa, Aa, Aa, Aa^Fpa, Aa, Aa, Aa, Aa, Aa, Aa, Aa, Aa, Aa, Aa, Aa, Aa, Aa, Aa, Aa, Aa, Aa, Aa^Fda, Aa, Aa^Fda, Aa^Fpa, Aa, Aa, Aa^Fpa, Aa, Aa, Aa, Aa^Fpa, Aa, Aa^Fpa, Aa, Aa, Aa^Fpa, Aa
Aa, Aa, Aa^Fpa, Aa^Fpa, Aa^Fpa, Aa^Fma, Aa^Fpa, Aa^Fdw, Aa^Fpa, Aa^Fdw, Aa^Fpa, Aa^Fpa, Aa, Aa, Aa, Aa^Fpa, Aa^Fma, Aa, Aa^Fpa, Aa^Fma, Aa^Fdw, Aa^Fpa, Aa, Cva, Aa^Fpa, Aa^Fpa, Aa, Aa, Aa, Aa, Aa, Aa, Aa, Aa, Aa, Aa, Aa, Aa^Fpa, Aa, Aa, Aa, Aa, Aa, Aa, Aa, Aa, Coa, Aa^Fpa, Aa, Aa, Aa, Aa, Aa, Aa, Aa, Aa, Aa^Fdw, Aa, Aa, Aa^Fda, Aa, Aa^Fpa, Aa^Fpa, Aa^Fdw, Aa^Fpa, Aa
Aa, Aa, Aa^Fpa, Aa, Aa^Fpa, Aa, Aa, Aa^Fma, Aa^Fma, Aa, Aa, Aa, Aa^Fpa, Aa, Aa^Fdw, Aa^Fpa, Aa, Aa, Aa^Fpa, Aa, Aa, Aa^Fpa, Aa^Fpa, Aa^Fpa, Aa, Aa, Aa, Aa^Fpa, Aa, Aa, Aa, Aa, Aa, Aa^Fpa, Aa, Aa, Aa, Aa, Aa, Aa, Aa, Rd, Aa, Aa, Aa, Coa, Cva, Coa, Re^Edb, Aa, Aa, Aa, Aa, Aa, Aa, Aa, Aa, Aa^Fpa, Aa^Fpa, Re, Aa^Fpa, Aa, Aa, Aa, Aa, Aa
Aa^Fpa, Aa^Fpa, Aa^Fpa, Aa^Fdw, Aa^Fpa, Aa, Aa^Fpa, Aa, Aa, Aa^Fpa, Aa^Fpa, Aa, Aa^Fpa, Aa^Fma, Aa^Fdw, Aa^Fma, Aa^Fdw, Aa^Fpa, Aa^Fma, Aa, Aa, Aa, Aa, Aa, Aa, Aa^Fpa, Aa, Aa, Aa, Aa, Aa, Aa, Aa, Aa, Aa^Fpa, Aa, Aa, Aa, Rd, Aa, Aa, Aa, Aa, Aa, Re^Edb, Cva, Kva, Cva, Re, Aa^Fpa, Aa, Re, Aa, Aa, Aa, Rd, Aa, Aa, Aa, Aa, Aa^Fpa, Aa, Re, Aa, Aa^Fpa, Aa
Aa^Fpa, Aa^Fma, Aa^Fma, Aa^Fdw, Aa^Fpa, Aa^Fpa, Aa, Aa, Aa^Fpa, Aa, Aa, Aa^Fpa, Aa, Aa^Fpa, Aa^Fpa, Aa, Aa, Aa^Fdw, Aa^Fpa, Aa, Aa, Aa, Aa, Aa, Aa, Aa, Aa^Fpa, Aa, Aa^Fpa, Aa, Aa, Aa, Aa, Aa, Aa, Aa, Aa, Rd, Aa, Aa, Aa, Aa, Cva, Re, Coa, Coa, Cva, Coa, Coa, Re^Edb, Cva, Aa, Aa, Aa, Aa, Aa, Aa, Aa, Aa, Aa, Aa, Aa, Aa^Fpa, Aa, Aa, Re
Aa^Fpa, Aa^Fma, Aa^Fma, Aa^Fpa, Aa, Aa^Fpa, Aa^Fdw, Aa^Fpa, Aa^Fpa, Aa^Fma, Aa^Fma, Aa, Aa^Fpa, Aa, Aa, Aa^Fpa, Aa, Aa^Fpa, Aa, Aa^Fpa, Aa, Aa, Aa, Aa, Aa, Aa, Aa, Rd, Rd, Aa, Aa, Aa, Rd, Aa, Aa, Aa, Aa, Aa, Aa, Aa, Cva, Cva, Rra, Cva, Rra, Rra, Aa, Rra, Rra, Cva, Rra, Cva, Cva, Aa, Aa, Aa^Fpa, Aa, Aa, Aa, Aa, Aa, Aa, Aa, Aa^Fpa, Aa^Fpa, Aa^Fpa
Aa^Fpa, Aa^Fma, Aa^Fpa, Aa^Fpa, Aa, Aa^Fdw, Aa^Fpa, Aa^Fpa, Aa^Fpa, Aa, Aa^Fpa, Aa^Fma, Ms, Aa^Fpa, Aa^Fpa, Aa, Aa, Aa^Fpa, Aa^Fda, Aa^Fdw, Aa^Fpa, Aa^Fpa, Aa, Aa, Rd, Aa, Aa, Aa, Aa, Aa, Aa, Rd, Rd, Rd, Aa, Aa, Aa, Aa, Cva, Cva, Rra, Aa, Ds, Rra, Aa^Fpa, Aa, Rra, Aa, Aa^Vea, Rra, Aa, Aa, Aa, Cva, Cva, Aa, Aa, Aa, Aa, Aa, Aa, Rb, Aa, Aa, Aa, Aa
Aa^Fpa, Aa^Fpa, Aa^Fpa, Aa, Aa^Fdw, Aa^Fdw, Aa, Aa, Aa^Fpa, Aa^Fdw, Aa^Fdw, Aa^Fpa, Ms, Aa^Fpa, Aa, Aa, Aa^Fda, Aa, Aa, Aa^Fda, Aa^Fdw, Aa^Fda, Aa, Aa, Aa, Aa, Aa, Aa, Aa, Aa, Aa, Aa, Aa, Aa, Aa, Aa, Cva, Cva, Rra, Rra, Ds, Aa, Ai, Ds, Aa^Fdw, Aa, Rra, Aa, Aa, Aa, Aa, Aa, Aa^Dr, Rra, Aa, Cva, Coa, Aa, Aa, Aa, Aa, Rb, Aa, Aa, Aa^Fpa, Aa^Fpa
Aa, Aa, Aa, Aa^Fpa, Aa^Fpa, Aa^Fpa, Aa, Aa^Fpa, Aa, Aa, Aa^Fpa, Aa^Fpa, Aa^Fma, Aa^Fpa, Aa^Fdw, Aa^Fda, Aa, Aa, Aa^Fpa, Aa, Aa, Aa, Aa, Aa^Fpa, Aa, Aa, Aa, Aa, Aa, Rd, Rd, Aa, Aa, Aa, Cva, Cva, Rra, Rra, Aa, Aa^Dr, Aa, Ai, Aa^Fdw, Ds, Aa^Fdw, Aa, Aa^Fetd, Aa^Fdw, Aa^Fdw, Aa^Fdw, Gd, Aa, Aa, Aa, Aa, Rra, Rra, Coa, Cva, Aa, Aa, Rb, Aa, Aa, Re, Re
Aa^Fpa, Aa, Aa^Fpa, Aa^Fpa, Aa, Aa^Fpa, Aa^Fpa, Aa, Aa, Aa, Aa^Fpa, Aa, Aa, Aa^Fma, Aa^Fdw, Aa^Fdw, Aa^Fpa, Aa^Fpa, Aa^Fpa, Aa^Fda, Aa, Aa, Aa, Aa, Aa, Aa, Aa, Aa, Aa, Aa, Aa, Aa, Aa, Cva, Rra, Rra, Aa^Vea, Aa, Aa, Aa, Aa^Vea, Aa, Aa, Aa, Aa, Aa, Ai, Aa, Aa, Aa^Fdw, Aa, Aa, Aa^Fpa, Aa^Fdw, Aa^Fdw, Aa, Aa^Vea, Rra, Cva, Aa, Aa, Aa, Aa, Aa, Aa^Fpa, Aa^Fpa
Aa, Aa, Aa^Fpa, Aa, Aa, Aa^Fpa, Aa^Fpa, Aa^Fpa, Ms, Aa^Fpa, Aa^Fpa, Aa^Fpa, Aa^Fpa, Aa^Fpa, Aa, Aa^Fda, Cva, Aa, Aa, Aa^Fpa, Aa, Aa, Aa^Fpa, Aa, Aa, Aa, Aa, Aa, Aa, Aa, Aa, Aa, Aa, Coa, Rra, Ds, Ai, Aa, Aa, Gd, Aa, Aa, Aa^Fetd, Aa, Ai, Ai, Kva, Ai, Ai, Aa, Aa^Fetd, Aa, Aa, Aa, Aa, Aa, Aa, Rra, Cva, Aa, Aa, Aa, Aa, Aa, Aa^Fpa, Aa^Fpa
Aa^Fpa, Aa^Fpa, Aa^Fpa, Aa^Fpa, Aa, Aa, Aa^Fpa, Aa^Fpa, Ms, Aa^Fpa, Aa^Fpa, Aa, Aa^Fpa, Aa^Fpa, Aa, Aa^Fpa, Ms, Aa^Fpa, Aa^Fpa, Aa^Fpa, Aa^Fpa, Aa, Aa, Aa, Aa^Fpa, Aa, Aa, Aa, Aa, Aa, Aa, Aa, Aa, Cva, Aa, Aa, Ds, Ds, Aa^Fdw, Aa, Aa, Aa, Aa, Ai, Kva, Cva, Aa^Feth, Cva, Kva, Ai, Aa, Aa, Aa^Vea, Ai, Ai, Ds, Ds, Rra, Cva, Aa, Aa, Aa, Aa, Aa, Aa, Aa
Aa^Fpa, Aa^Fpa, Aa^Fpa, Aa^Fpa, Aa, Aa^Fpa, Aa^Fpa, Aa^Fpa, Aa^Fpa, Aa^Fpa, Aa^Fpa, Aa, Aa^Fpa, Aa, Aa, Aa^Fda, Ms, Aa^Fpa, Aa, Aa^Fpa, Aa, Aa, Aa^Fpa, Aa, Aa, Aa, Aa, Aa, Rd, Aa, Aa, Aa, Aa, Cva, Aa, Ds, Ai, Ds, Aa^Fdw, Aa, Aa^Dr, Aa, Aa, Ai, Cva, Aa, Cva, Aa, Cva, Ai, Aa, Aa, Aa, Ds, Aa, Ai, Aa, Aa, Cva, Aa, Aa, Aa, Rb, Aa, Aa^Fpa, Aa^Fpa
Aa^Fpa, Aa^Fpa, Aa, Aa, Aa, Aa^Fpa, Rb, Aa, Aa^Fpa, Aa, Aa^Fpa, Rb, Rb, Aa^Fpa, Aa, Aa^Fda, Aa^Fpa, Aa^Fpa, Aa, Aa^Fpa, Aa^Fpa, Ms, Aa, Aa^Fpa, Aa^Fpa, Aa, Aa, Rd, Rd, Aa, Aa, Aa, Cva, Cva, Rra, Ds, Ai, Aa, Aa, Aa, Aa, Aa, Aa^Fetd, Ai, Ai, Kva, Aa, Kva, Ai, Ai, Aa^Fetd, Aa, Aa^Fdw, Aa^Fdw, Ds, Ai, Aa^Dr, Rra, Cva, Aa, Aa, Aa, Aa, Aa, Aa^Fpa, Aa^Fpa
Aa^Fpa, Aa, Aa^Fpa, Aa^Fpa, Aa, Aa^Fpa, Aa^Fpa, Aa, Aa^Fpa, Aa, Aa^Fpa, Rb, Aa^Fpa, Ms, Aa^Fpa, Aa^Fdw, Aa^Fpa, Aa^Fma, Aa^Fpa, Aa, Aa^Fpa, Aa^Fpa, Ms, Aa, Aa, Aa, Aa, Aa, Aa, Rd, Aa, Aa, Cva, Cva, Rra, Aa^Vea, Aa, Aa, Aa^Fdw, Aa^Fpa, Aa, Aa, Aa, Aa, Aa, Ai, Ai^Bsb|, Ai, Aa, Aa, Aa, Aa, Aa^Vea, Aa^Fpa, Aa, Aa, Aa, Rra, Cva, Aa, Aa, Aa, Aa, Aa, Aa, Aa^Fpa
Aa^Fpa, Aa, Aa, Aa^Fpa, Aa^Fpa, Aa, Aa, Aa^Fpa, Aa^Fpa, Aa, Aa, Aa^Fpa, Aa^Fpa, Ms, Aa, Aa^Fpa, Aa, Aa, Aa, Aa^Fpa, Aa, Aa^Fpa, Aa^Fpa, Ms, Aa, Aa, Aa, Aa, Aa, Aa, Aa, Aa, Cva, Kva, Rb, Aa, Rb, Aa, Aa, Rb, Aa^Fpa, Aa, Aa^Vea, Aa, Aa, Kva, Rra, Kva, Aa, Aa^Dr, Aa, Aa^Fpa, Aa^Fdw, Aa^Fdw, Aa, Aa, Aa, Rra, Cva, Aa, Aa, Rb, Aa, Aa, Aa, Aa
Aa^Fpa, Aa, Aa, Aa^Fpa, Aa, Aa, Aa^Fpa, Aa^Fda, Aa^Fda, Aa^Fpa, Aa^Fpa, Aa, Aa^Fpa, Aa, Aa^Fda, Aa^Fdw, Aa^Fda, Aa, Aa, Aa^Fda, Aa^Fpa, Aa, Aa, Ms, Aa^Fpa, Aa, Aa, Rb, Aa, Aa, Aa, Aa, Re, Rra, Rra, Rb, Aa, Aa, Aa^Vea, Aa, Aa, Aa, Aa, Aa, Aa, Aa, Aa, Aa, Aa, Aa, Aa, Aa^Fdw, Aa, Aa^Fpa, Rra, Rra, Cva, Cva, Aa, Aa, Aa, Aa, Aa, Aa^Fpa, Aa, Aa
Aa^Fpa, Aa^Fpa, Aa, Aa^Fpa, Aa^Fpa, Aa^Fpa, Ms, Aa^Fpa, Ms, Aa^Fpa, Aa^Fpa, Aa, Aa, Aa, Aa^Fda, Aa^Fdw, Aa, Aa^Fpa, Aa^Fda, Aa^Fda, Aa^Fdw, Aa^Fdw, Aa^Fda, Aa, Aa^Fdw, Aa, Rd, Aa, Aa, Aa, Aa, Aa, Aa, Aa, Cva, Kva, Cva, Rra, Rra, Aa, Aa, Ha, Ha, Aa^Fdw, Aa^Fdw, Aa, Rra, Aa, Aa^Vea, Aa, Aa, Aa, Aa, Rra, Cva, Cva, Aa, Aa, Aa, Aa, Aa, Aa, Aa, Aa, Aa, Aa
Aa^Fpa, Aa^Fpa, Aa^Fma, Aa^Fma, Aa^Fdw, Ms, Aa^Fpa, Ms, Aa^Fda, Aa^Fpa, Aa^Fda, Aa, Aa^Fpa, Aa, Aa, Aa^Fpa, Aa^Fpa, Aa, Aa, Aa^Fdw, Aa^Fpa, Aa^Fpa, Aa, Aa^Fdw, Aa^Fpa, Aa, Aa, Rd, Aa, Re, Aa, Aa, Aa, Aa, Aa, Cva, Aa, Cva, Cva, Rra, Rra, Aa^Vea, Rra, Ha, Aa, Aa^Fpa, Rra, Aa, Rra, Aa, Aa, Aa, Cva, Cva, Aa, Aa, Aa, Aa, Aa, Aa, Aa, Aa, Rb, Aa, Aa, Aa
Aa^Fpa, Aa^Fpa, Aa^Fpa, Aa, Aa^Fdw, Aa^Fda, Aa^Fda, Aa^Fpa, Aa^Fpa, Aa^Fpa, Aa^Fpa, Aa, Aa^Fpa, Aa^Fpa, Aa, Aa^Fpa, Aa^Fpa, Aa^Fpa, Aa, Aa, Re, Re, Aa, Aa, Re, Aa, Aa, Aa, Aa, Aa, Re, Re^Edb, Aa, Aa, Aa, Aa, Aa, Aa, Aa, Cva, Cva, Rra, Cva, Aa, Cva, Rra, Cva, Rra, Cva, Rra, Cva, Cva, Aa, Aa, Aa, Aa, Aa, Aa, Rb, Aa, Aa, Aa, Aa, Aa, Aa^Fpa, Aa^Fpa
Aa^Fpa, Aa^Fma, Aa^Fpa, Aa, Aa, Aa^Fma, Aa^Fdw, Aa, Ms, Aa, Aa^Fpa, Aa^Fpa, Aa^Fma, Aa, Aa^Fpa, Aa, Aa, Aa, Aa, Aa^Fpa, Aa^Fpa, Aa^Fpa, Aa^Fpa, Aa^Fpa, Aa^Fpa, Re, Aa^Fpa, Aa, Re, Aa, Ms, Aa, Aa, Aa, Aa, Rb, Aa, Aa, Aa, Aa, Aa, Cva, Aa, Cva, Aa, Cva, Aa, Cva, Aa, Cva, Aa, Aa, Aa, Aa^Fpa, Rb, Aa, Aa, Rb, Aa, Aa, Aa, Aa, Aa, Aa, Aa^Fpa, Aa^Fpa
Aa, Aa, Aa^Fpa, Aa^Fpa, Aa, Aa^Fma, Aa^Fdw, Aa^Fpa, Aa^Fpa, Ms, Ms, Aa^Fma, Ms, Aa^Fma, Aa^Fpa, Re^Edb, Aa^Fpa, Aa^Fpa, Aa^Fpa, Aa, Aa, Aa^Fpa, Aa, Aa^Fpa, Ms, Aa^Fpa, Aa, Aa, Aa, Aa, Aa, Ms, Aa, Aa^Fpa, Aa, Aa, Aa, Aa, Rd, Aa, Aa, Aa, Aa, Aa, Aa, Aa, Aa, Aa, Rb, Aa, Aa, Aa, Aa, Rb, Aa, Aa, Aa, Aa, Aa, Aa, Rb, Aa, Aa, Aa, Aa, Aa
Aa^Fpa, Aa^Fpa, Aa^Fpa, Aa^Fpa, Aa, Aa^Fpa, Aa, Aa, Aa^Fpa, Aa^Fma, Aa^Fpa, Aa^Fpa, Gd, Ms, Aa, Aa, Aa^Fpa, Aa^Fma, Ms, Aa, Aa^Fpa, Cva, Aa, Aa^Fpa, Re, Aa, Aa^Fpa, Aa^Fpa, Aa, Aa, Gd, Aa, Aa, Aa, Aa, Aa, Aa, Aa, Aa, Rd, Rd, Aa, Aa, Aa, Aa, Aa, Aa, Rb, Aa, Aa, Aa, Aa, Aa, Aa, Aa, Aa, Aa, Aa^Fpa, Aa, Aa^Fpa, Aa, Aa, Aa^Fpa, Aa, Aa^Fpa, Aa^Fpa
Aa^Fpa, Aa^Fdw, Aa^Fda, Aa^Fdw, Aa^Fpa, Aa, Aa^Fpa, Aa, Aa, Aa^Fpa, Aa^Fpa, Aa, Aa^Fpa, Aa, Aa^Fdw, Aa^Fpa, Ms, Ms, Aa^Fpa, Aa, Aa^Fpa, Aa^Fpa, Aa^Fpa, Aa, Re, Aa^Fpa, Aa^Fpa, Ms, Aa^Fpa, Aa, Aa, Aa, Rd, Aa, Aa, Ms, Aa, Aa, Aa, Aa, Ms, Aa, Aa^Fpa, Aa, Rb, Aa, Aa, Aa, Aa, Rb, Aa, Aa, Aa^Fpa, Aa, Aa, Aa^Fpa, Aa, Aa, Aa^Fpa, Aa, Aa, Aa, Aa^Fdw, Aa, Aa^Fpa, Aa^Fpa
Aa, Aa, Aa, Aa^Fpa, Aa^Fpa, Aa, Aa^Fpa, Aa, Aa, Aa, Re, Re, Aa^Fdw, Aa^Fdw, Aa^Fpa, Ms, Aa^Fpa, Ms, Aa, Aa, Aa, Aa, Aa, Aa, Aa, Aa^Fpa, Aa, Ms, Aa, Aa, Aa^Fpa, Aa, Aa^Fpa, Aa, Aa, Aa, Aa, Aa^Fpa, Aa^Fpa, Aa^Fpa, Ms, Aa^Fpa, Aa, Aa, Aa, Aa, Aa, Aa, Aa, Aa, Aa, Aa^Fpa, Aa, Aa, Aa, Aa^Fpa, Aa^Fpa, Aa^Fpa, Aa, Aa, Aa, Aa, Aa^Fdw, Aa^Fpa, Aa, Aa^Fpa
Aa^Fpa, Aa^Fpa, Aa^Fpa, Aa, Aa, Aa^Fpa, Aa, Aa^Fpa, Re, Aa^Fpa, Aa^Fpa, Aa^Fda, Aa^Fdw, Aa^Fdw, Aa, Aa^Fpa, Aa, Aa, Aa^Fpa, Aa, Re, Re, Aa^Fpa, Aa^Fpa, Aa^Fpa, Aa, Aa^Fpa, Aa, Aa^Fpa, Aa, Aa^Fpa, Aa^Fpa, Aa, Aa^Fpa, Aa^Fpa, Aa, Aa, Aa^Fpa, Aa, Aa^Fpa, Aa, Ms, Aa, Aa, Aa, Aa^Fpa, Aa^Fpa, Aa^Fpa, Aa^Fpa, Aa, Aa^Fpa, Aa^Fpa, Aa^Fpa, Aa^Fpa, Aa, Aa^Fpa, Aa, Aa^Fpa, Aa, Aa, Aa, Aa, Aa^Fpa, Aa^Fpa, Aa, Aa^Fpa
Aa, Aa^Fpa, Aa^Fpa, Aa^Fpa, Aa^Fpa, Aa^Fpa, Aa^Fpa, Aa, Re, Aa^Fpa, Aa^Fpa, Aa, Aa^Fpa, Aa, Aa, Aa, Aa^Fpa, Ms, Ms, Ms, Re, Aa^Fpa, Aa^Fpa, Aa, Aa^Fpa, Aa, Aa^Fpa, Aa, Aa, Aa, Aa, Aa^Fpa, Aa^Fpa, Aa^Fpa, Aa^Fpa, Aa^Fpa, Aa, Aa, Aa, Aa^Fpa, Aa^Fpa, Aa^Fpa, Aa, Aa^Fpa, Aa, Aa, Aa^Fpa, Aa^Fpa, Aa^Fpa, Aa, Aa^Fpa, Aa, Aa^Fpa, Aa, Aa^Fpa, Aa^Fpa, Aa, Aa^Fpa, Aa, Aa^Fpa, Aa^Fpa, Aa^Fpa, Aa, Aa^Fpa, Aa, Aa
Aa^Fpa, Aa^Fpa, Aa^Fpa, Aa^Fpa, Aa^Fpa, Aa, Aa^Fpa, Aa, Aa, Aa, Aa^Fpa, Aa, Aa, Gd, Aa, Aa^Fpa, Aa^Fpa, Aa^Fpa, Aa^Fpa, Aa^Fpa, Aa, Aa^Fpa, Aa, Aa^Fpa, Aa, Aa^Fpa, Aa, Aa^Fpa, Aa^Fpa, Aa, Aa^Fpa, Aa^Fpa, Aa, Aa^Fpa, Aa, Aa, Aa, Aa^Fpa, Aa^Fpa, Aa, Aa^Fpa, Aa^Fpa, Aa^Fdw, Aa^Fpa, Aa^Fpa, Aa, Aa, Aa^Fpa, Aa, Aa^Fpa, Aa^Fpa, Aa^Fdw, Aa^Fdw, Aa^Fdw, Aa, Aa^Fdw, Aa^Fdw, Aa, Aa^Fpa, Aa^Fpa, Aa, Aa^Fpa, Aa^Fpa, Aa, Aa, Aa
Aa, Aa^Fpa, Aa, Aa^Fpa, Aa^Fpa, Aa^Fpa, Aa^Fpa, Aa, Aa^Fpa, Aa, Aa^Fpa, Aa^Fpa, Aa, Aa, Aa^Fpa, Aa, Aa^Fpa, Aa, Re, Aa, Aa^Fpa, Aa, Aa^Fpa, Aa^Fpa, Aa^Fpa, Aa^Fpa, Aa^Fdw, Aa^Fpa, Aa^Fpa, Aa, Aa, Aa^Fpa, Aa^Fdw, Aa, Aa, Aa, Aa^Fpa, Aa^Fpa, Aa^Fpa, Aa, Aa^Fdw, Aa^Fdw, Aa, Aa^Fpa, Aa, Aa^Fpa, Ms, Aa^Fpa, Aa^Fpa, Aa^Fpa, Aa, Aa^Fda, Aa, Gd, Aa^Fpa, Aa, Aa^Fpa, Aa^Fpa, Aa, Aa, Aa^Fpa, Aa^Fpa, Aa, Aa, Aa^Fpa, Aa^Fpa
Aa, Aa, Aa, Aa^Fpa, Aa^Fpa, Aa, Aa^Fpa, Re, Aa, Aa^Fpa, Aa, Aa^Fpa, Aa, Aa, Aa^Fpa, Aa^Fpa, Aa, Re, Aa^Fpa, Aa^Fpa, Aa^Fpa, Ms, Aa^Fpa, Aa, Aa^Fpa, Aa^Fpa, Aa^Fpa, Aa^Fdw, Aa^Fpa, Aa, Aa^Fpa, Aa^Fpa, Aa^Fpa, Aa, Aa, Aa, Aa^Fpa, Aa, Aa^Fpa, Aa, Aa^Fdw, Aa^Fdw, Aa^Fpa, Aa^Fpa, Aa, Ms, Ms, Aa^Fpa, Aa, Aa^Fpa, Aa^Fdw, Aa^Fpa, Aa, Aa^Fpa, Aa^Fda, Cva, Aa^Fpa, Aa, Aa^Fpa, Aa^Fpa, Aa, Aa, Aa^Fdw, Aa^Fdw, Aa^Fpa, Aa^Fpa
Aa, Aa, Aa^Fpa, Aa^Fpa, Aa^Fpa, Aa^Fpa, Re, Re, Aa, Aa, Aa, Aa^Fpa, Aa^Fpa, Aa, Aa, Aa^Fpa, Aa, Aa, Aa, Aa, Aa^Fpa, Aa^Fpa, Aa^Fpa, Aa, Ms, Aa^Fpa, Aa, Aa^Fdw, Aa^Fdw, Aa^Fpa, Aa^Fpa, Aa, Aa, Aa^Fpa, Aa^Fpa, Aa^Fpa, Aa, Cva, Aa^Fpa, Aa^Fpa, Aa, Aa, Aa, Aa, Aa, Aa^Fpa, Aa^Fpa, Aa^Fpa, Aa^Fpa, Aa^Fdw, Aa^Fdw, Aa^Fdw, Aa, Aa^Fpa, Aa, Aa^Fda, Aa, Aa, Aa^Fpa, Aa^Fpa, Aa, Aa^Fdw, Aa^Fda, Aa^Fda, Aa^Fpa, Aa^Fpa
Aa, Aa, Aa, Aa, Re, Aa, Aa, Aa^Fpa, Aa, Aa, Aa, Aa, Aa, Aa^Fpa, Aa^Fpa, Aa, Re, Aa^Fpa, Aa, Aa, Aa, Aa^Fpa, Aa^Fpa, Aa, Aa^Fpa, Ms, Ms, Aa, Aa, Aa, Aa^Fpa, Aa, Aa, Aa^Fpa, Aa, Aa^Fpa, Aa, Aa, Aa^Fpa, Aa^Fpa, Aa, Aa^Fpa, Aa, Aa, Aa, Aa^Fpa, Aa, Aa^Fpa, Aa^Fpa, Aa, Aa^Fpa, Aa^Fpa, Aa, Aa^Fpa, Aa, Aa, Aa^Fpa, Aa^Fpa, Aa^Fpa, Aa, Aa^Fpa, Aa, Aa^Fdw, Aa^Fdw, Aa^Fpa, Aa^Fpa
Aa, Aa, Aa, Re, Aa^Fpa, Aa, Aa, Aa, Aa^Fpa, Aa^Fpa, Aa^Fpa, Aa^Fpa, Rb, Aa^Fpa, Aa, Aa, Re, Aa^Fpa, Aa^Fpa, Aa, Aa^Fpa, Aa^Fpa, Aa, Aa^Fpa, Aa, Aa^Fpa, Aa^Fpa, Ms, Aa, Aa^Fpa, Aa^Fpa, Aa^Fpa, Aa, Aa^Fpa, Aa, Aa^Fpa, Aa^Fpa, Aa^Fpa, Aa^Fpa, Aa, Aa^Fpa, Aa, Aa^Fpa, Aa, Aa^Fpa, Aa^Fpa, Aa, Aa, Aa, Aa, Aa^Fpa, Aa, Aa, Aa^Fpa, Aa^Fpa, Aa, Aa, Aa^Fpa, Aa, Aa, Aa^Fpa, Aa, Aa^Fpa, Aa, Aa, Aa
Aa^Fpa, Aa, Aa, Aa, Aa^Fpa, Aa^Fpa, Aa^Fpa, Aa, Aa, Aa^Fpa, Aa^Fpa, Aa, Aa, Aa^Fpa, Aa, Aa, Aa^Fpa, Aa, Aa^Fpa, Aa^Fpa, Aa, Aa^Fpa, Aa, Aa^Fpa, Aa^Fpa, Aa^Fpa, Aa^Fpa, Aa, Aa^Fpa, Aa, Aa, Aa^Fpa, Aa^Fma, Aa, Aa, Aa^Fda, Aa^Fpa, Ms, Ms, Aa^Fpa, Aa^Fpa, Aa^Fpa, Aa, Aa, Aa^Fpa, Aa, Aa, Aa^Fpa, Aa^Fpa, Aa^Fpa, Aa^Fdw, Aa^Fdw, Aa^Fdw, Aa, Aa, Gd, Aa^Fpa, Aa^Fpa, Aa^Fpa, Aa^Fpa, Aa^Fpa, Aa, Aa^Fpa, Aa^Fpa, Aa^Fpa, Aa^Fpa
Aa, Aa^Fpa, Aa, Aa, Aa^Fpa, Aa, Aa^Fpa, Aa, Aa, Aa, Aa, Aa^Fpa, Aa^Fpa, Aa^Fpa, Aa, Re, Aa^Fpa, Aa, Aa, Aa, Gd, Aa^Fpa, Aa^Fpa, Aa^Fpa, Aa, Aa, Aa^Fpa, Aa^Fpa, Aa^Fpa, Aa^Fpa, Ms, Aa^Fpa, Aa^Fma, Aa^Fpa, Aa^Fpa, Aa^Fda, Aa, Aa^Fpa, Aa^Fpa, Aa^Fpa, Aa, Aa^Fpa, Aa, Aa^Fpa, Aa^Fpa, Aa^Fpa, Aa^Fpa, Aa^Fpa, Aa^Fpa, Aa^Fpa, Aa, Aa, Aa^Fpa, Aa^Fdw, Aa, Aa, Aa^Fpa, Aa^Fpa, Aa^Fpa, Aa, Aa^Fdw, Aa^Fpa, Aa, Aa^Fpa, Aa^Fpa, Aa^Fpa
Aa, Aa, Aa^Fpa, Aa^Fpa, Aa, Aa, Aa^Fpa, Aa, Aa^Fpa, Aa, Aa, Aa^Fpa, Aa, Aa^Fpa, Aa^Fpa, Re, Aa^Fpa, Aa, Aa, Aa, Aa^Fpa, Aa^Fpa, Aa^Fpa, Aa^Fpa, Aa, Aa^Fpa, Aa, Aa^Fpa, Aa, Aa^Fpa, Aa^Fpa, Aa^Fma, Aa, Aa^Fdw, Aa, Aa^Fpa, Aa^Fpa, Aa, Aa, Aa^Fpa, Aa, Aa^Fpa, Aa^Fpa, Aa, Aa, Aa^Fpa, Aa, Gd, Gd, Aa, Aa^Fpa, Aa, Aa^Fpa, Aa^Fpa, Aa, Aa^Fpa, Aa^Fpa, Aa, Aa, Aa^Fdw, Aa, Aa^Fpa, Aa^Fpa, Aa, Aa, Aa
Aa, Aa, Aa, Aa, Aa, Aa^Fpa, Aa, Aa^Fpa, Aa^Fpa, Aa^Fpa, Aa^Fpa, Aa^Fpa, Aa, Aa, Aa, Aa, Aa^Fpa, Aa, Aa, Aa, Aa, Aa, Aa^Fda, Aa, Aa^Fpa, Aa, Aa^Fpa, Aa^Fpa, Aa^Fpa, Aa, Aa, Aa^Fpa, Aa, Aa^Fpa, Aa, Aa, Aa^Fpa, Aa^Fpa, Aa^Fdw, Aa, Aa^Fpa, Aa^Fpa, Aa^Fdw, Aa^Fpa, Aa^Fpa, Aa^Fpa, Aa^Fdw, Aa^Fpa, Aa^Fpa, Aa^Fpa, Aa, Aa, Aa, Aa, Aa^Fpa, Aa, Aa^Fpa, Aa^Fpa, Aa^Fdw, Aa^Fpa, Aa^Fpa, Aa^Fpa, Aa^Fpa, Aa, Aa, Aa^Fpa
Aa^Fpa, Aa^Fpa, Aa, Aa, Aa, Aa^Fpa, Aa, Aa^Fpa, Aa, Aa^Fpa, Aa, Aa^Fpa, Aa, Aa^Fpa, Aa, Aa, Aa, Aa, Aa, Aa, Aa^Fpa, Aa, Aa^Fda, Aa^Fpa, Aa^Fpa, Aa^Fpa, Aa, Aa, Aa, Aa^Fpa, Aa, Aa, Aa, Aa^Fpa, Aa^Fpa, Aa, Aa, Aa^Fpa, Aa^Fpa, Aa^Fdw, Aa^Fdw, Aa^Fpa, Aa^Fpa, Aa, Aa, Aa^Fpa, Aa^Fdw, Aa^Fpa, Aa^Fdw, Aa^Fpa, Aa^Fpa, Aa^Fpa, Aa, Aa, Aa^Fpa, Aa^Fpa, Aa, Aa^Fdw, Aa, Aa, Aa^Fpa, Aa^Fpa, Aa^Fpa, Aa, Aa, Aa^Fpa
Aa^Fpa, Aa, Aa^Fpa, Aa^Fpa, Aa, Aa, Aa^Fpa, Aa, Aa^Fpa, Aa^Fpa, Aa, Aa^Fpa, Aa, Aa^Fpa, Aa, Aa^Fpa, Aa^Fpa, Aa^Fpa, Aa^Fpa, Aa^Fpa, Aa, Aa^Fpa, Aa, Aa^Fpa, Aa^Fpa, Aa^Fpa, Aa, Aa, Aa, Aa^Fpa, Gd, Aa, Aa, Aa^Fpa, Aa^Fpa, Aa, Aa, Aa^Fpa, Aa^Fpa, Aa, Aa^Fpa, Aa^Fdw, Aa^Fpa, Aa^Fpa, Aa, Aa^Fdw, Aa^Fdw, Aa^Fdw, Aa^Fdw, Aa^Fdw, Aa^Fpa, Aa^Fpa, Aa^Fpa, Aa, Aa^Fpa, Aa^Fpa, Aa, Aa^Fpa, Aa, Aa, Aa, Aa, Aa, Aa, Aa, Aa^Fpa
Aa^Fpa, Aa^Fpa, Aa^Fpa, Aa^Fpa, Aa^Fpa, Aa^Fpa, Aa^Fpa, Aa^Fpa, Aa, Aa, Aa, Aa^Fpa, Aa, Aa^Fpa, Aa, Aa, Aa, Aa, Aa, Aa, Aa, Aa, Aa, Aa, Aa, Aa, Aa, Aa, Aa, Aa, Aa, Aa, Aa, Aa, Aa, Aa, Aa, Aa, Aa^Fpa, Aa, Aa^Fpa, Aa, Aa, Aa^Fpa, Aa, Aa, Aa, Aa, Aa, Aa, Aa, Aa, Aa, Aa, Aa, Aa^Fpa, Aa, Aa^Fpa, Aa^Fpa, Aa, Aa^Fpa, Aa^Fpa, Aa, Aa, Aa, Aa^Fpa
