Ds, Ds, Ds, Ds, Ds^Ii, Ds, Ds, Ds, Ds, Ds, Ds^Ii
Ds, Ds, Ds^Ii, Ds, Ds, Ds, Ds, Ds, Ds, Ds, Wwg
Ds, Ds, Ds, Ds, Ds, Ds, Ds, Ds^Ii, Wwg, Wwg, Wog
Ds^Ii, Ds, Ds, Ds, Ds^Ii, Ds, Ds, Wwg, Wog, Wog, Wog
Ds, Ds, Ds, Ds, Ds, Ds, Wwg, Wwg, Wog^Ii, Wog, Wog
Ds, Ds, Ds^Ii, Ds, Wwg, Wwg, Wog, Wog, Wog, Wog, Wog
Ds, Ds, Ds, Ds, Wwg, Wog^Ii, Wog, Wog, Wog, Wog, Wog
Ds, Ds, Wwg, Wwg, Wog, Wog, Wog, Wog, Wog^Ii, Wog, Wog
Ds, Ds^Ii, Wwg, Wog, Wog^Ii, Wog, Wog, Wog, Wog, Wog, Wog
Wwg^_fme, Wwg, Wwg, Wog, Wog, Wog, Wog, Wog, Wog, Wog, Wog
