Qxua, Qxua, Qxua, Qxua, Qxua, Qxua, Qxua, Qxua, Qxua, Qxua, Qxua, Qxua, Qxua
Qxua, Qxua, Qxua, Qxua, Qxua, Qxua, Aa^Feta, Qxua, Qxua, Qxua, Qxua, Qxua, Qxua
Qxua, Qxua, Qxua, Qxua, Qxua, Qxua, Cha, Qxua, Qxua, Qxua, Qxua, Qxua, Qxua
Qxua, Qxua, Aa^Feta, Qxua, Cha, Cha, Kha^Ii, Cha, Cha, Qxua, Aa^Feta, Qxua, Qxua
Qxua, Qxua, Qxua, Kha^Ii, Aa, Aa^Feta, Rra, Aa^Feta, Aa, Kha^Ii, Qxua, Qxua, Qxua
Qxua, Qxua, Qxua, Cha, Aa, Aa, Rra, Aa, Aa, Cha, Qxua, Qxua, Qxua
Qxua, Qxua, Qxua, Cha, Aa, Aa, Rra, Aa, Aa, Cha, Qxua, Qxua, Qxua
Qxua, Qxua, Aa^Feta, Kha^Ii, Cha, Aa, Rra, Aa, Cha, Kha^Ii, Aa^Feta, Qxua, Qxua
Qxua, Qxua, Qxua, Qxua, Qxua, Cha, Rra, Cha, Qxua, Qxua, Qxua, Qxua, Qxua
Qxua, Qxua, Qxua, Qxua, Aa^Feta, Kha^Ii, Qxua^Bsb|, Kha^Ii, Aa^Feta, Qxua, Qxua, Qxua, Qxua
Qxua, Qxua, Qxua, Qxua, Qxua, Qxua, Qxua^Bsb|, Qxua, Qxua, Qxua, Qxua, Qxua, Qxua
Qxua, Qxua, Qxua, Qxua, Qxua, Qxua, Qxua^Bsb|, Qxua, Qxua, Qxua, Qxua, Qxua, Qxua
Qxua, Qxua, Qxua, Qxua, Qxua, Qxua, Qxua^Bsb|, Qxua, Qxua, Qxua, Qxua, Qxua, Qxua
